"","Team","Opponent","Loss","Win","WinProb","Matches"
"1","Air Force","Ark Pine Bluff",0,3,1,3
"2","Air Force","Army",1,2,0.666666666666667,3
"3","Air Force","Boise St",5,2,0.285714285714286,7
"4","Air Force","Citadel",0,2,1,2
"5","Air Force","Colorado",3,0,0,3
"6","Air Force","Colorado St",6,0,0,6
"7","Air Force","Florida",1,0,0,1
"8","Air Force","Fresno St",5,1,0.166666666666667,6
"9","Air Force","Grambling",0,1,1,1
"10","Air Force","Jackson St",1,1,0.5,2
"11","Air Force","Jacksonville St",0,1,1,1
"12","Air Force","Montana St",0,1,1,1
"13","Air Force","NE Omaha",0,1,1,1
"14","Air Force","Nevada",4,2,0.333333333333333,6
"15","Air Force","New Mexico",3,3,0.5,6
"16","Air Force","New Orleans",0,1,1,1
"17","Air Force","Richmond",2,0,0,2
"18","Air Force","San Diego St",5,1,0.166666666666667,6
"19","Air Force","San Jose St",0,4,1,4
"20","Air Force","South Dakota",0,1,1,1
"21","Air Force","Texas Tech",1,0,0,1
"22","Air Force","UC Davis",2,0,0,2
"23","Air Force","UC Riverside",0,2,1,2
"24","Air Force","UNLV",3,3,0.5,6
"25","Air Force","Utah St",2,1,0.333333333333333,3
"26","Air Force","VMI",1,0,0,1
"27","Air Force","Wichita St",1,0,0,1
"28","Air Force","Wyoming",1,4,0.8,5
"29","Air Force","Colorado Chr",0,2,1,2
"30","Air Force","Western St CO",0,2,1,2
"31","Akron","Ark Pine Bluff",0,2,1,2
"32","Akron","Ball St",0,4,1,4
"33","Akron","Bethune-Cookman",0,1,1,1
"34","Akron","Bowling Green",0,6,1,6
"35","Akron","Bryant",0,1,1,1
"36","Akron","Buffalo",4,3,0.428571428571429,7
"37","Akron","Cleveland St",0,2,1,2
"38","Akron","C Michigan",0,3,1,3
"39","Akron","Coastal Car",1,1,0.5,2
"40","Akron","Coppin St",0,3,1,3
"41","Akron","Creighton",1,0,0,1
"42","Akron","Detroit",1,1,0.5,2
"43","Akron","E Michigan",1,3,0.75,4
"44","Akron","Iowa St",1,0,0,1
"45","Akron","Kent",4,4,0.5,8
"46","Akron","Marshall",0,2,1,2
"47","Akron","Miami FL",1,0,0,1
"48","Akron","Miami OH",3,3,0.5,6
"49","Akron","Middle Tenn St",1,1,0.5,2
"50","Akron","N Dakota St",1,1,0.5,2
"51","Akron","N Illinois",1,3,0.75,4
"52","Akron","Ohio",2,5,0.714285714285714,7
"53","Akron","Oklahoma St",1,0,0,1
"54","Akron","Oral Roberts",0,1,1,1
"55","Akron","Oregon St",0,1,1,1
"56","Akron","Penn St",1,1,0.5,2
"57","Akron","Princeton",0,1,1,1
"58","Akron","South Carolina",2,1,0.333333333333333,3
"59","Akron","St Mary's CA",1,0,0,1
"60","Akron","Toledo",3,1,0.25,4
"61","Akron","TX Southern",0,1,1,1
"62","Akron","UNC Asheville",0,1,1,1
"63","Akron","USC",0,1,1,1
"64","Akron","W Illinois",0,1,1,1
"65","Akron","W Michigan",2,4,0.666666666666667,6
"66","Akron","UMBC",0,1,1,1
"67","Akron","Bluffton",0,1,1,1
"68","Akron","MTSU",1,0,0,1
"69","Alabama","Appalachian St",0,1,1,1
"70","Alabama","Arizona St",0,1,1,1
"71","Alabama","Arkansas",2,2,0.5,4
"72","Alabama","Auburn",2,4,0.666666666666667,6
"73","Alabama","Charleston So",0,2,1,2
"74","Alabama","Cincinnati",1,0,0,1
"75","Alabama","Dayton",1,0,0,1
"76","Alabama","Drexel",1,0,0,1
"77","Alabama","Duke",1,0,0,1
"78","Alabama","Florida",5,0,0,5
"79","Alabama","Georgia",2,2,0.5,4
"80","Alabama","Georgia St",0,1,1,1
"81","Alabama","Iowa St",1,0,0,1
"82","Alabama","Kentucky",3,1,0.25,4
"83","Alabama","Lamar",0,1,1,1
"84","Alabama","LSU",3,2,0.4,5
"85","Alabama","Mercer",1,0,0,1
"86","Alabama","Mississippi",3,1,0.25,4
"87","Alabama","Mississippi St",0,4,1,4
"88","Alabama","Missouri",2,2,0.5,4
"89","Alabama","North Florida",0,2,1,2
"90","Alabama","Oakland",0,1,1,1
"91","Alabama","Oklahoma",1,0,0,1
"92","Alabama","Oregon St",0,1,1,1
"93","Alabama","Robert Morris",0,1,1,1
"94","Alabama","S Dakota St",0,1,1,1
"95","Alabama","South Carolina",2,2,0.5,4
"96","Alabama","Southern Miss",0,1,1,1
"97","Alabama","South Florida",1,1,0.5,2
"98","Alabama","Tennessee",2,2,0.5,4
"99","Alabama","Tennessee Tech",0,1,1,1
"100","Alabama","Texas A&M",1,3,0.75,4
"101","Alabama","Texas Tech",0,2,1,2
"102","Alabama","Towson",0,1,1,1
"103","Alabama","Tulane",1,0,0,1
"104","Alabama","UCLA",1,1,0.5,2
"105","Alabama","VA Commonwealth",1,0,0,1
"106","Alabama","Vanderbilt",2,2,0.5,4
"107","Alabama","Villanova",0,1,1,1
"108","Alabama","W Carolina",0,1,1,1
"109","Alabama","Wichita St",2,0,0,2
"110","Alabama","Xavier",2,0,0,2
"111","Alabama","Stillman",0,2,1,2
"112","Alabama A&M","Alabama St",3,3,0.5,6
"113","Alabama A&M","Alcorn St",3,3,0.5,6
"114","Alabama A&M","Arkansas",1,0,0,1
"115","Alabama A&M","Ark Pine Bluff",5,2,0.285714285714286,7
"116","Alabama A&M","Bowling Green",1,0,0,1
"117","Alabama A&M","Dayton",1,0,0,1
"118","Alabama A&M","E Kentucky",1,0,0,1
"119","Alabama A&M","Evansville",1,0,0,1
"120","Alabama A&M","Georgia Tech",1,0,0,1
"121","Alabama A&M","Grambling",0,6,1,6
"122","Alabama A&M","Iowa St",1,0,0,1
"123","Alabama A&M","Jackson St",3,3,0.5,6
"124","Alabama A&M","Jacksonville St",3,0,0,3
"125","Alabama A&M","Marquette",1,0,0,1
"126","Alabama A&M","Mercer",1,0,0,1
"127","Alabama A&M","Mississippi St",0,1,1,1
"128","Alabama A&M","Missouri St",1,1,0.5,2
"129","Alabama A&M","MS Valley St",1,5,0.833333333333333,6
"130","Alabama A&M","Murray St",1,0,0,1
"131","Alabama A&M","New Mexico",1,0,0,1
"132","Alabama A&M","Ohio",1,0,0,1
"133","Alabama A&M","Prairie View",5,2,0.285714285714286,7
"134","Alabama A&M","SE Missouri St",1,0,0,1
"135","Alabama A&M","Southern Univ",7,0,0,7
"136","Alabama A&M","Tennessee St",1,1,0.5,2
"137","Alabama A&M","TX Southern",5,1,0.166666666666667,6
"138","Alabama A&M","UAB",1,0,0,1
"139","Alabama A&M","Vanderbilt",1,0,0,1
"140","Alabama A&M","Virginia Tech",1,0,0,1
"141","Alabama A&M","W Michigan",2,0,0,2
"142","Alabama A&M","AL Huntsville",0,1,1,1
"143","Alabama A&M","Oakwood",0,2,1,2
"144","Alabama St","Alabama A&M",3,3,0.5,6
"145","Alabama St","Alcorn St",0,7,1,7
"146","Alabama St","Arkansas",1,0,0,1
"147","Alabama St","Ark Pine Bluff",3,3,0.5,6
"148","Alabama St","Bradley",1,0,0,1
"149","Alabama St","Chicago St",1,1,0.5,2
"150","Alabama St","Detroit",1,0,0,1
"151","Alabama St","Evansville",2,0,0,2
"152","Alabama St","Florida",1,0,0,1
"153","Alabama St","Georgia Tech",1,0,0,1
"154","Alabama St","Grambling",0,6,1,6
"155","Alabama St","Illinois",1,0,0,1
"156","Alabama St","Jackson St",2,4,0.666666666666667,6
"157","Alabama St","Jacksonville St",0,2,1,2
"158","Alabama St","Middle Tenn St",1,0,0,1
"159","Alabama St","MS Valley St",0,7,1,7
"160","Alabama St","North Dakota",1,0,0,1
"161","Alabama St","Pepperdine",1,0,0,1
"162","Alabama St","Prairie View",3,3,0.5,6
"163","Alabama St","Savannah St",1,0,0,1
"164","Alabama St","Southern Univ",5,2,0.285714285714286,7
"165","Alabama St","Troy",2,1,0.333333333333333,3
"166","Alabama St","Tulane",1,0,0,1
"167","Alabama St","TX Pan American",1,1,0.5,2
"168","Alabama St","TX Southern",6,1,0.142857142857143,7
"169","Alabama St","UCF",1,0,0,1
"170","Alabama St","Utah",1,0,0,1
"171","Alabama St","W Illinois",1,1,0.5,2
"172","Alabama St","WI Milwaukee",1,0,0,1
"173","Alabama St","Auburn M'gomery",0,2,1,2
"174","Alabama St","Fort Valley St",0,1,1,1
"175","Alabama St","Mobile",0,1,1,1
"176","Alabama St","Thomas GA",0,1,1,1
"177","Albany NY","Binghamton",0,6,1,6
"178","Albany NY","Boston Univ",2,0,0,2
"179","Albany NY","Brown",0,2,1,2
"180","Albany NY","Bucknell",2,0,0,2
"181","Albany NY","Colgate",1,2,0.666666666666667,3
"182","Albany NY","Drake",1,0,0,1
"183","Albany NY","Duquesne",1,1,0.5,2
"184","Albany NY","Fairfield",0,2,1,2
"185","Albany NY","Hartford",1,5,0.833333333333333,6
"186","Albany NY","Holy Cross",2,0,0,2
"187","Albany NY","Loyola MD",1,0,0,1
"188","Albany NY","Maine",1,7,0.875,8
"189","Albany NY","MD Baltimore Co",0,2,1,2
"190","Albany NY","Missouri KC",0,1,1,1
"191","Albany NY","Navy",0,1,1,1
"192","Albany NY","New Hampshire",1,6,0.857142857142857,7
"193","Albany NY","Niagara",1,0,0,1
"194","Albany NY","NJIT",0,4,1,4
"195","Albany NY","Ohio St",1,0,0,1
"196","Albany NY","Pittsburgh",1,0,0,1
"197","Albany NY","Providence",1,0,0,1
"198","Albany NY","Quinnipiac",3,0,0,3
"199","Albany NY","Rider",0,1,1,1
"200","Albany NY","S Carolina St",0,2,1,2
"201","Albany NY","Siena",0,3,1,3
"202","Albany NY","St Francis NY",0,1,1,1
"203","Albany NY","St Francis PA",1,0,0,1
"204","Albany NY","Stony Brook",4,5,0.555555555555556,9
"205","Albany NY","UNLV",1,0,0,1
"206","Albany NY","Vermont",4,3,0.428571428571429,7
"207","Albany NY","Wagner",0,1,1,1
"208","Albany NY","Washington",0,1,1,1
"209","Albany NY","Yale",0,2,1,2
"210","Albany NY","MA Lowell",1,3,0.75,4
"211","Albany NY","UMBC",1,4,0.8,5
"212","Alcorn St","Alabama A&M",3,3,0.5,6
"213","Alcorn St","Alabama St",7,0,0,7
"214","Alcorn St","Arkansas",1,0,0,1
"215","Alcorn St","Ark Pine Bluff",4,2,0.333333333333333,6
"216","Alcorn St","California",1,0,0,1
"217","Alcorn St","Canisius",1,0,0,1
"218","Alcorn St","Creighton",1,0,0,1
"219","Alcorn St","Denver",1,0,0,1
"220","Alcorn St","Detroit",1,0,0,1
"221","Alcorn St","FL Gulf Coast",1,0,0,1
"222","Alcorn St","Grambling",1,6,0.857142857142857,7
"223","Alcorn St","Hampton",1,0,0,1
"224","Alcorn St","Houston",1,0,0,1
"225","Alcorn St","Iowa",1,0,0,1
"226","Alcorn St","Jackson St",4,2,0.333333333333333,6
"227","Alcorn St","Jacksonville St",2,0,0,2
"228","Alcorn St","Kennesaw",1,0,0,1
"229","Alcorn St","Mercer",1,0,0,1
"230","Alcorn St","Mississippi St",1,0,0,1
"231","Alcorn St","Missouri",1,0,0,1
"232","Alcorn St","MS Valley St",2,4,0.666666666666667,6
"233","Alcorn St","Murray St",1,0,0,1
"234","Alcorn St","N Dakota St",1,0,0,1
"235","Alcorn St","Ohio",1,0,0,1
"236","Alcorn St","Prairie View",2,4,0.666666666666667,6
"237","Alcorn St","Samford",0,1,1,1
"238","Alcorn St","Santa Clara",1,0,0,1
"239","Alcorn St","SMU",1,0,0,1
"240","Alcorn St","Southern Univ",5,1,0.166666666666667,6
"241","Alcorn St","Stanford",1,0,0,1
"242","Alcorn St","St Mary's CA",1,0,0,1
"243","Alcorn St","Syracuse",1,0,0,1
"244","Alcorn St","Temple",1,0,0,1
"245","Alcorn St","Texas",1,0,0,1
"246","Alcorn St","Troy",2,0,0,2
"247","Alcorn St","TX Southern",7,0,0,7
"248","Alcorn St","UTEP",1,0,0,1
"249","Alcorn St","W Illinois",1,0,0,1
"250","Alcorn St","Wright St",1,0,0,1
"251","Alcorn St","Dillard",0,2,1,2
"252","Alcorn St","Mississippi Col",0,1,1,1
"253","Alcorn St","Tougaloo",0,1,1,1
"254","Alcorn St","Concordia AL",1,0,0,1
"255","American Univ","Army",5,2,0.285714285714286,7
"256","American Univ","Boston Univ",3,2,0.4,5
"257","American Univ","Brown",1,1,0.5,2
"258","American Univ","Bucknell",5,1,0.166666666666667,6
"259","American Univ","Colgate",2,6,0.75,8
"260","American Univ","Columbia",3,0,0,3
"261","American Univ","Cornell",1,0,0,1
"262","American Univ","FL Atlantic",1,0,0,1
"263","American Univ","George Mason",1,0,0,1
"264","American Univ","Georgetown",1,0,0,1
"265","American Univ","Hampton",1,1,0.5,2
"266","American Univ","Holy Cross",1,6,0.857142857142857,7
"267","American Univ","Howard",1,1,0.5,2
"268","American Univ","Illinois",1,0,0,1
"269","American Univ","Kansas",1,0,0,1
"270","American Univ","Lafayette",3,4,0.571428571428571,7
"271","American Univ","La Salle",0,1,1,1
"272","American Univ","Lehigh",3,4,0.571428571428571,7
"273","American Univ","Louisiana Tech",1,0,0,1
"274","American Univ","Loyola MD",2,2,0.5,4
"275","American Univ","MD Baltimore Co",0,1,1,1
"276","American Univ","MD E Shore",0,2,1,2
"277","American Univ","Minnesota",1,0,0,1
"278","American Univ","Morehead St",0,1,1,1
"279","American Univ","Mt St Mary's",1,2,0.666666666666667,3
"280","American Univ","Navy",2,4,0.666666666666667,6
"281","American Univ","Ohio St",1,0,0,1
"282","American Univ","Presbyterian",0,1,1,1
"283","American Univ","Quinnipiac",0,1,1,1
"284","American Univ","San Francisco",2,0,0,2
"285","American Univ","St Francis PA",0,3,1,3
"286","American Univ","St Joseph's PA",1,0,0,1
"287","American Univ","St Mary's CA",1,0,0,1
"288","American Univ","Stony Brook",1,0,0,1
"289","American Univ","Temple",1,0,0,1
"290","American Univ","UMBC",0,1,1,1
"291","Appalachian St","Alabama",1,0,0,1
"292","Appalachian St","Arkansas St",1,1,0.5,2
"293","Appalachian St","Ark Little Rock",2,0,0,2
"294","Appalachian St","Campbell",2,0,0,2
"295","Appalachian St","Charlotte",2,0,0,2
"296","Appalachian St","Chattanooga",3,1,0.25,4
"297","Appalachian St","Cincinnati",1,0,0,1
"298","Appalachian St","Citadel",1,2,0.666666666666667,3
"299","Appalachian St","Col Charleston",1,0,0,1
"300","Appalachian St","Davidson",3,0,0,3
"301","Appalachian St","Duquesne",2,0,0,2
"302","Appalachian St","East Carolina",1,0,0,1
"303","Appalachian St","Elon",3,1,0.25,4
"304","Appalachian St","Furman",2,1,0.333333333333333,3
"305","Appalachian St","Ga Southern",2,3,0.6,5
"306","Appalachian St","Georgia",1,0,0,1
"307","Appalachian St","Georgia St",1,1,0.5,2
"308","Appalachian St","Georgia Tech",1,0,0,1
"309","Appalachian St","Hampton",0,1,1,1
"310","Appalachian St","High Point",1,0,0,1
"311","Appalachian St","Hofstra",1,0,0,1
"312","Appalachian St","Jacksonville",0,1,1,1
"313","Appalachian St","Missouri",1,0,0,1
"314","Appalachian St","Missouri KC",0,1,1,1
"315","Appalachian St","NC Central",1,0,0,1
"316","Appalachian St","NC State",1,0,0,1
"317","Appalachian St","Ohio",1,0,0,1
"318","Appalachian St","Presbyterian",1,1,0.5,2
"319","Appalachian St","Samford",2,3,0.6,5
"320","Appalachian St","South Alabama",1,1,0.5,2
"321","Appalachian St","South Carolina",1,0,0,1
"322","Appalachian St","Texas St",0,2,1,2
"323","Appalachian St","Troy",0,2,1,2
"324","Appalachian St","ULL",2,0,0,2
"325","Appalachian St","ULM",1,1,0.5,2
"326","Appalachian St","UNC Greensboro",2,2,0.5,4
"327","Appalachian St","UT Arlington",1,1,0.5,2
"328","Appalachian St","Virginia Tech",1,1,0.5,2
"329","Appalachian St","W Carolina",3,1,0.25,4
"330","Appalachian St","Winthrop",1,0,0,1
"331","Appalachian St","Wofford",1,1,0.5,2
"332","Appalachian St","Bluefield VA",0,1,1,1
"333","Appalachian St","Lee-McRae",0,1,1,1
"334","Appalachian St","Milligan",0,1,1,1
"335","Appalachian St","North Greenville",0,1,1,1
"336","Arizona","Arizona St",2,4,0.666666666666667,6
"337","Arizona","California",2,4,0.666666666666667,6
"338","Arizona","Cal Poly SLO",0,1,1,1
"339","Arizona","Charleston So",0,1,1,1
"340","Arizona","Clemson",0,1,1,1
"341","Arizona","Colorado",1,6,0.857142857142857,7
"342","Arizona","CS Northridge",0,1,1,1
"343","Arizona","Drexel",0,1,1,1
"344","Arizona","Duke",0,1,1,1
"345","Arizona","ETSU",0,1,1,1
"346","Arizona","F Dickinson",0,1,1,1
"347","Arizona","Florida",0,1,1,1
"348","Arizona","Gardner Webb",0,1,1,1
"349","Arizona","Gonzaga",0,1,1,1
"350","Arizona","Kansas St",0,1,1,1
"351","Arizona","Long Beach St",0,2,1,2
"352","Arizona","Miami FL",0,1,1,1
"353","Arizona","Michigan",0,2,1,2
"354","Arizona","Missouri",0,1,1,1
"355","Arizona","Mt St Mary's",0,1,1,1
"356","Arizona","New Mexico St",0,1,1,1
"357","Arizona","Northern Arizona",0,2,1,2
"358","Arizona","Oakland",0,1,1,1
"359","Arizona","Oral Roberts",0,1,1,1
"360","Arizona","Oregon",2,4,0.666666666666667,6
"361","Arizona","Oregon St",1,4,0.8,5
"362","Arizona","Rhode Island",0,1,1,1
"363","Arizona","San Diego St",0,3,1,3
"364","Arizona","Southern Miss",0,1,1,1
"365","Arizona","Southern Univ",0,1,1,1
"366","Arizona","Stanford",0,5,1,5
"367","Arizona","Texas Tech",0,2,1,2
"368","Arizona","UC Irvine",0,1,1,1
"369","Arizona","UCLA",3,3,0.5,6
"370","Arizona","UNLV",1,1,0.5,2
"371","Arizona","USC",1,3,0.75,4
"372","Arizona","Utah",0,7,1,7
"373","Arizona","Utah Valley",0,1,1,1
"374","Arizona","UTEP",0,2,1,2
"375","Arizona","Washington",0,4,1,4
"376","Arizona","Washington St",1,3,0.75,4
"377","Arizona St","Alabama",1,0,0,1
"378","Arizona St","Arizona",4,2,0.333333333333333,6
"379","Arizona St","Arkansas",0,1,1,1
"380","Arizona St","Ark Pine Bluff",0,1,1,1
"381","Arizona St","Bethune-Cookman",0,1,1,1
"382","Arizona St","Bradley",0,1,1,1
"383","Arizona St","California",0,5,1,5
"384","Arizona St","Cent Arkansas",0,1,1,1
"385","Arizona St","Chicago St",0,1,1,1
"386","Arizona St","Col Charleston",0,1,1,1
"387","Arizona St","Colgate",0,1,1,1
"388","Arizona St","Colorado",2,4,0.666666666666667,6
"389","Arizona St","Coppin St",0,1,1,1
"390","Arizona St","Cornell",0,1,1,1
"391","Arizona St","Creighton",2,0,0,2
"392","Arizona St","CS Northridge",0,1,1,1
"393","Arizona St","CS Sacramento",0,1,1,1
"394","Arizona St","Dartmouth",0,1,1,1
"395","Arizona St","DePaul",1,1,0.5,2
"396","Arizona St","Detroit",0,1,1,1
"397","Arizona St","Florida A&M",0,1,1,1
"398","Arizona St","Grambling",0,1,1,1
"399","Arizona St","Hartford",0,1,1,1
"400","Arizona St","Harvard",0,1,1,1
"401","Arizona St","Idaho St",0,1,1,1
"402","Arizona St","Lehigh",1,0,0,1
"403","Arizona St","Loy Marymount",0,1,1,1
"404","Arizona St","Marquette",1,1,0.5,2
"405","Arizona St","Maryland",1,0,0,1
"406","Arizona St","Miami FL",1,0,0,1
"407","Arizona St","Miami OH",0,1,1,1
"408","Arizona St","Oregon",4,1,0.2,5
"409","Arizona St","Oregon St",2,3,0.6,5
"410","Arizona St","Pepperdine",0,1,1,1
"411","Arizona St","Stanford",4,2,0.333333333333333,6
"412","Arizona St","Texas A&M",1,0,0,1
"413","Arizona St","Texas Tech",0,2,1,2
"414","Arizona St","UC Irvine",0,1,1,1
"415","Arizona St","UCLA",2,2,0.5,4
"416","Arizona St","UNLV",0,2,1,2
"417","Arizona St","USC",2,3,0.6,5
"418","Arizona St","Utah",4,2,0.333333333333333,6
"419","Arizona St","Washington",3,1,0.25,4
"420","Arizona St","Washington St",1,3,0.75,4
"421","Arizona St","UMBC",0,1,1,1
"422","Arkansas","Alabama",2,2,0.5,4
"423","Arkansas","Alabama A&M",0,1,1,1
"424","Arkansas","Alabama St",0,1,1,1
"425","Arkansas","Alcorn St",0,1,1,1
"426","Arkansas","Arizona St",1,0,0,1
"427","Arkansas","Auburn",0,4,1,4
"428","Arkansas","California",1,0,0,1
"429","Arkansas","Clemson",1,1,0.5,2
"430","Arkansas","Dayton",0,1,1,1
"431","Arkansas","Delaware St",0,2,1,2
"432","Arkansas","Edwardsville",0,1,1,1
"433","Arkansas","Florida",3,1,0.25,4
"434","Arkansas","Florida A&M",0,1,1,1
"435","Arkansas","Georgia",1,4,0.8,5
"436","Arkansas","Gonzaga",1,0,0,1
"437","Arkansas","High Point",0,1,1,1
"438","Arkansas","Iona",0,1,1,1
"439","Arkansas","Iowa St",1,0,0,1
"440","Arkansas","Kentucky",2,3,0.6,5
"441","Arkansas","Longwood",0,1,1,1
"442","Arkansas","LSU",3,1,0.25,4
"443","Arkansas","Michigan",1,0,0,1
"444","Arkansas","Minnesota",0,1,1,1
"445","Arkansas","Mississippi",2,2,0.5,4
"446","Arkansas","Mississippi St",0,4,1,4
"447","Arkansas","Missouri",3,3,0.5,6
"448","Arkansas","North Texas",0,1,1,1
"449","Arkansas","Northwestern LA",0,2,1,2
"450","Arkansas","Oklahoma",0,1,1,1
"451","Arkansas","Robert Morris",0,1,1,1
"452","Arkansas","Sam Houston St",0,1,1,1
"453","Arkansas","Savannah St",0,1,1,1
"454","Arkansas","SE Louisiana",0,1,1,1
"455","Arkansas","SE Missouri St",0,1,1,1
"456","Arkansas","SMU",0,2,1,2
"457","Arkansas","South Alabama",0,1,1,1
"458","Arkansas","South Carolina",2,3,0.6,5
"459","Arkansas","Syracuse",1,0,0,1
"460","Arkansas","Tennessee",2,3,0.6,5
"461","Arkansas","Texas A&M",2,2,0.5,4
"462","Arkansas","TN Martin",0,1,1,1
"463","Arkansas","ULL",0,1,1,1
"464","Arkansas","Utah Valley",0,1,1,1
"465","Arkansas","UT San Antonio",0,1,1,1
"466","Arkansas","Vanderbilt",1,3,0.75,4
"467","Arkansas","Wake Forest",0,1,1,1
"468","Arkansas","WI Milwaukee",0,1,1,1
"469","Arkansas","Wisconsin",1,0,0,1
"470","Arkansas St","Appalachian St",1,1,0.5,2
"471","Arkansas St","Ark Little Rock",4,3,0.428571428571429,7
"472","Arkansas St","Austin Peay",0,1,1,1
"473","Arkansas St","Cent Arkansas",0,3,1,3
"474","Arkansas St","Colorado",1,0,0,1
"475","Arkansas St","Dayton",1,0,0,1
"476","Arkansas St","FL Atlantic",1,1,0.5,2
"477","Arkansas St","Florida Intl",2,0,0,2
"478","Arkansas St","Ga Southern",2,0,0,2
"479","Arkansas St","Georgia St",5,0,0,5
"480","Arkansas St","Jackson St",0,1,1,1
"481","Arkansas St","Kent",1,0,0,1
"482","Arkansas St","Lamar",1,2,0.666666666666667,3
"483","Arkansas St","Marshall",0,2,1,2
"484","Arkansas St","Middle Tenn St",1,1,0.5,2
"485","Arkansas St","Mississippi St",0,1,1,1
"486","Arkansas St","Murray St",1,0,0,1
"487","Arkansas St","Nebraska",1,0,0,1
"488","Arkansas St","Niagara",0,2,1,2
"489","Arkansas St","North Texas",1,1,0.5,2
"490","Arkansas St","Purdue",1,0,0,1
"491","Arkansas St","South Alabama",1,5,0.833333333333333,6
"492","Arkansas St","St Bonaventure",0,1,1,1
"493","Arkansas St","Texas St",1,3,0.75,4
"494","Arkansas St","TN Martin",1,2,0.666666666666667,3
"495","Arkansas St","Toledo",2,0,0,2
"496","Arkansas St","Troy",3,3,0.5,6
"497","Arkansas St","ULL",5,1,0.166666666666667,6
"498","Arkansas St","ULM",2,4,0.666666666666667,6
"499","Arkansas St","UT Arlington",1,3,0.75,4
"500","Arkansas St","W Kentucky",1,3,0.75,4
"501","Arkansas St","Wyoming",1,0,0,1
"502","Arkansas St","Belhaven MS",0,1,1,1
"503","Arkansas St","Lyon",0,1,1,1
"504","Arkansas St","S Arkansas",0,1,1,1
"505","Ark Little Rock","Appalachian St",0,2,1,2
"506","Ark Little Rock","Arkansas St",3,4,0.571428571428571,7
"507","Ark Little Rock","Bradley",0,1,1,1
"508","Ark Little Rock","BYU",1,0,0,1
"509","Ark Little Rock","Cent Arkansas",0,1,1,1
"510","Ark Little Rock","Cincinnati",1,0,0,1
"511","Ark Little Rock","CS Northridge",0,1,1,1
"512","Ark Little Rock","FL Atlantic",1,1,0.5,2
"513","Ark Little Rock","Florida",1,0,0,1
"514","Ark Little Rock","Florida Intl",1,1,0.5,2
"515","Ark Little Rock","Ga Southern",2,0,0,2
"516","Ark Little Rock","Georgia St",3,1,0.25,4
"517","Ark Little Rock","Grambling",0,1,1,1
"518","Ark Little Rock","Jacksonville",0,1,1,1
"519","Ark Little Rock","Jacksonville St",0,1,1,1
"520","Ark Little Rock","Kent",1,0,0,1
"521","Ark Little Rock","Louisiana Tech",2,0,0,2
"522","Ark Little Rock","Memphis",1,0,0,1
"523","Ark Little Rock","Middle Tenn St",3,0,0,3
"524","Ark Little Rock","Mississippi",1,0,0,1
"525","Ark Little Rock","Missouri KC",0,1,1,1
"526","Ark Little Rock","Missouri St",1,0,0,1
"527","Ark Little Rock","North Florida",1,0,0,1
"528","Ark Little Rock","North Texas",0,2,1,2
"529","Ark Little Rock","Oklahoma",1,0,0,1
"530","Ark Little Rock","SMU",0,1,1,1
"531","Ark Little Rock","South Alabama",5,2,0.285714285714286,7
"532","Ark Little Rock","South Carolina",1,0,0,1
"533","Ark Little Rock","Southern Miss",1,0,0,1
"534","Ark Little Rock","Southern Univ",0,1,1,1
"535","Ark Little Rock","Texas St",1,3,0.75,4
"536","Ark Little Rock","TN Martin",0,1,1,1
"537","Ark Little Rock","Troy",2,5,0.714285714285714,7
"538","Ark Little Rock","Tulsa",2,1,0.333333333333333,3
"539","Ark Little Rock","ULL",4,2,0.333333333333333,6
"540","Ark Little Rock","ULM",4,2,0.333333333333333,6
"541","Ark Little Rock","UT Arlington",3,1,0.25,4
"542","Ark Little Rock","WI Green Bay",1,0,0,1
"543","Ark Little Rock","WI Milwaukee",0,1,1,1
"544","Ark Little Rock","W Kentucky",1,3,0.75,4
"545","Ark Little Rock","Arkansas-FS",0,1,1,1
"546","Ark Little Rock","S Arkansas",0,1,1,1
"547","Ark Little Rock","Ark Monticello",0,1,1,1
"548","Ark Pine Bluff","Air Force",3,0,0,3
"549","Ark Pine Bluff","Akron",2,0,0,2
"550","Ark Pine Bluff","Alabama A&M",2,5,0.714285714285714,7
"551","Ark Pine Bluff","Alabama St",3,3,0.5,6
"552","Ark Pine Bluff","Alcorn St",2,4,0.666666666666667,6
"553","Ark Pine Bluff","Arizona St",1,0,0,1
"554","Ark Pine Bluff","Auburn",1,0,0,1
"555","Ark Pine Bluff","C Michigan",2,0,0,2
"556","Ark Pine Bluff","Creighton",1,0,0,1
"557","Ark Pine Bluff","CS Bakersfield",0,1,1,1
"558","Ark Pine Bluff","Grambling",0,6,1,6
"559","Ark Pine Bluff","Hampton",1,0,0,1
"560","Ark Pine Bluff","Hawaii",2,0,0,2
"561","Ark Pine Bluff","High Point",1,0,0,1
"562","Ark Pine Bluff","Houston",0,1,1,1
"563","Ark Pine Bluff","Houston Bap",1,0,0,1
"564","Ark Pine Bluff","Iowa",1,0,0,1
"565","Ark Pine Bluff","Jackson St",2,4,0.666666666666667,6
"566","Ark Pine Bluff","MD E Shore",0,1,1,1
"567","Ark Pine Bluff","Michigan St",2,0,0,2
"568","Ark Pine Bluff","MS Valley St",1,5,0.833333333333333,6
"569","Ark Pine Bluff","Ohio",1,0,0,1
"570","Ark Pine Bluff","Oklahoma St",1,0,0,1
"571","Ark Pine Bluff","Oregon",1,0,0,1
"572","Ark Pine Bluff","Oregon St",1,0,0,1
"573","Ark Pine Bluff","Prairie View",2,4,0.666666666666667,6
"574","Ark Pine Bluff","Sam Houston St",1,0,0,1
"575","Ark Pine Bluff","San Diego St",1,0,0,1
"576","Ark Pine Bluff","SMU",1,0,0,1
"577","Ark Pine Bluff","Southern Univ",4,2,0.333333333333333,6
"578","Ark Pine Bluff","Southern Utah",0,1,1,1
"579","Ark Pine Bluff","Stanford",1,0,0,1
"580","Ark Pine Bluff","Texas A&M",1,0,0,1
"581","Ark Pine Bluff","Texas Tech",1,0,0,1
"582","Ark Pine Bluff","TX Southern",4,2,0.333333333333333,6
"583","Ark Pine Bluff","UTEP",1,0,0,1
"584","Ark Pine Bluff","Valparaiso",1,0,0,1
"585","Ark Pine Bluff","Washington St",1,0,0,1
"586","Ark Pine Bluff","Abilene Chr",1,0,0,1
"587","Ark Pine Bluff","Morehouse",0,1,1,1
"588","Ark Pine Bluff","Tuskegee",0,1,1,1
"589","Army","Air Force",2,1,0.333333333333333,3
"590","Army","American Univ",2,5,0.714285714285714,7
"591","Army","Binghamton",0,2,1,2
"592","Army","Boston Univ",4,1,0.2,5
"593","Army","Bryant",2,0,0,2
"594","Army","Bucknell",6,2,0.25,8
"595","Army","Citadel",0,1,1,1
"596","Army","Colgate",2,4,0.666666666666667,6
"597","Army","Columbia",2,0,0,2
"598","Army","Dartmouth",1,0,0,1
"599","Army","Delaware",1,1,0.5,2
"600","Army","Duke",1,0,0,1
"601","Army","Holy Cross",3,3,0.5,6
"602","Army","Houston Bap",1,1,0.5,2
"603","Army","Lafayette",2,4,0.666666666666667,6
"604","Army","Lehigh",4,2,0.333333333333333,6
"605","Army","Loyola MD",1,3,0.75,4
"606","Army","Maine",0,3,1,3
"607","Army","Marist",0,2,1,2
"608","Army","Navy",5,2,0.285714285714286,7
"609","Army","NJIT",2,0,0,2
"610","Army","Notre Dame",1,0,0,1
"611","Army","Penn St",1,0,0,1
"612","Army","Rutgers",1,0,0,1
"613","Army","St Francis NY",0,3,1,3
"614","Army","Texas A&M",1,0,0,1
"615","Army","USC",0,1,1,1
"616","Army","VMI",0,2,1,2
"617","Army","Yale",1,0,0,1
"618","Army","Coast Guard",0,2,1,2
"619","Auburn","Alabama",4,2,0.333333333333333,6
"620","Auburn","Arkansas",4,0,0,4
"621","Auburn","Ark Pine Bluff",0,1,1,1
"622","Auburn","Boston College",1,1,0.5,2
"623","Auburn","Clemson",1,1,0.5,2
"624","Auburn","Coastal Car",1,0,0,1
"625","Auburn","Col Charleston",0,1,1,1
"626","Auburn","Colorado",1,0,0,1
"627","Auburn","Dayton",1,0,0,1
"628","Auburn","DePaul",1,0,0,1
"629","Auburn","Florida",4,0,0,4
"630","Auburn","Florida A&M",0,1,1,1
"631","Auburn","Florida St",0,1,1,1
"632","Auburn","Furman",0,1,1,1
"633","Auburn","Georgia",2,2,0.5,4
"634","Auburn","Grambling",0,1,1,1
"635","Auburn","Illinois",2,0,0,2
"636","Auburn","Iowa St",1,0,0,1
"637","Auburn","IPFW",0,1,1,1
"638","Auburn","Jacksonville St",0,1,1,1
"639","Auburn","Kentucky",5,0,0,5
"640","Auburn","LSU",2,3,0.6,5
"641","Auburn","Mississippi",4,0,0,4
"642","Auburn","Mississippi St",3,2,0.4,5
"643","Auburn","Missouri",3,1,0.25,4
"644","Auburn","Murray St",1,1,0.5,2
"645","Auburn","Nicholls St",0,1,1,1
"646","Auburn","Northwestern LA",1,0,0,1
"647","Auburn","Oregon St",0,1,1,1
"648","Auburn","Rhode Island",1,0,0,1
"649","Auburn","South Carolina",1,4,0.8,5
"650","Auburn","Tennessee",4,0,0,4
"651","Auburn","Tennessee St",0,1,1,1
"652","Auburn","Tennessee Tech",0,1,1,1
"653","Auburn","Texas A&M",3,2,0.4,5
"654","Auburn","Texas Tech",1,0,0,1
"655","Auburn","Tulsa",1,0,0,1
"656","Auburn","TX Southern",0,1,1,1
"657","Auburn","ULL",0,1,1,1
"658","Auburn","Vanderbilt",4,0,0,4
"659","Auburn","WI Milwaukee",0,1,1,1
"660","Auburn","Winthrop",1,1,0.5,2
"661","Auburn","Xavier",0,1,1,1
"662","Auburn","MTSU",0,1,1,1
"663","Auburn","North Alabama",0,1,1,1
"664","Austin Peay","Arkansas St",1,0,0,1
"665","Austin Peay","Belmont",3,0,0,3
"666","Austin Peay","Brown",0,1,1,1
"667","Austin Peay","C Michigan",1,0,0,1
"668","Austin Peay","CS Northridge",1,0,0,1
"669","Austin Peay","DePaul",1,0,0,1
"670","Austin Peay","Edwardsville",4,2,0.333333333333333,6
"671","Austin Peay","E Illinois",3,3,0.5,6
"672","Austin Peay","E Kentucky",3,0,0,3
"673","Austin Peay","ETSU",2,0,0,2
"674","Austin Peay","Fairfield",1,0,0,1
"675","Austin Peay","Gardner Webb",1,0,0,1
"676","Austin Peay","High Point",1,0,0,1
"677","Austin Peay","Illinois",1,0,0,1
"678","Austin Peay","Illinois St",1,0,0,1
"679","Austin Peay","Indiana St",1,0,0,1
"680","Austin Peay","Jacksonville St",3,0,0,3
"681","Austin Peay","Liberty",1,1,0.5,2
"682","Austin Peay","Lipscomb",4,0,0,4
"683","Austin Peay","Memphis",2,0,0,2
"684","Austin Peay","Mississippi",1,0,0,1
"685","Austin Peay","Montana St",0,1,1,1
"686","Austin Peay","Morehead St",2,1,0.333333333333333,3
"687","Austin Peay","Murray St",6,0,0,6
"688","Austin Peay","North Florida",0,1,1,1
"689","Austin Peay","Samford",2,1,0.333333333333333,3
"690","Austin Peay","SE Missouri St",5,1,0.166666666666667,6
"691","Austin Peay","SF Austin",1,0,0,1
"692","Austin Peay","S Illinois",1,1,0.5,2
"693","Austin Peay","Tennessee St",1,2,0.666666666666667,3
"694","Austin Peay","Tennessee Tech",2,1,0.333333333333333,3
"695","Austin Peay","TN Martin",3,3,0.5,6
"696","Austin Peay","Troy",0,1,1,1
"697","Austin Peay","Utah Valley",1,0,0,1
"698","Austin Peay","Vanderbilt",1,0,0,1
"699","Austin Peay","W Carolina",0,1,1,1
"700","Austin Peay","W Kentucky",2,0,0,2
"701","Austin Peay","Youngstown St",0,1,1,1
"702","Austin Peay","Dalton St",0,1,1,1
"703","Austin Peay","Oakland City",0,2,1,2
"704","Austin Peay","Berea",0,1,1,1
"705","Ball St","Akron",4,0,0,4
"706","Ball St","Bethune-Cookman",0,1,1,1
"707","Ball St","Bowling Green",5,0,0,5
"708","Ball St","Buffalo",3,1,0.25,4
"709","Ball St","Butler",2,0,0,2
"710","Ball St","Cleveland St",2,0,0,2
"711","Ball St","C Michigan",3,3,0.5,6
"712","Ball St","E Illinois",1,0,0,1
"713","Ball St","E Michigan",4,2,0.333333333333333,6
"714","Ball St","Grambling",0,2,1,2
"715","Ball St","Indiana",1,0,0,1
"716","Ball St","Indiana St",2,1,0.333333333333333,3
"717","Ball St","IUPUI",2,0,0,2
"718","Ball St","James Madison",2,0,0,2
"719","Ball St","Kent",4,0,0,4
"720","Ball St","Longwood",0,1,1,1
"721","Ball St","Marquette",1,0,0,1
"722","Ball St","Miami OH",2,1,0.333333333333333,3
"723","Ball St","N Illinois",4,2,0.333333333333333,6
"724","Ball St","Norfolk St",0,1,1,1
"725","Ball St","Ohio",4,0,0,4
"726","Ball St","Purdue",1,0,0,1
"727","Ball St","San Diego St",1,0,0,1
"728","Ball St","SE Missouri St",0,2,1,2
"729","Ball St","S Illinois",1,0,0,1
"730","Ball St","South Dakota",0,2,1,2
"731","Ball St","Toledo",5,1,0.166666666666667,6
"732","Ball St","Utah",2,0,0,2
"733","Ball St","Valparaiso",2,0,0,2
"734","Ball St","W Michigan",4,2,0.333333333333333,6
"735","Ball St","Wofford",0,1,1,1
"736","Ball St","IU Kokomo",0,1,1,1
"737","Ball St","Oakland City",0,1,1,1
"738","Ball St","Taylor IN",0,1,1,1
"739","Baylor","Boston College",0,1,1,1
"740","Baylor","BYU",0,1,1,1
"741","Baylor","Charleston So",0,1,1,1
"742","Baylor","Col Charleston",1,0,0,1
"743","Baylor","Colorado",1,1,0.5,2
"744","Baylor","Dayton",0,1,1,1
"745","Baylor","Gonzaga",1,0,0,1
"746","Baylor","Illinois",1,0,0,1
"747","Baylor","Iowa St",4,3,0.428571428571429,7
"748","Baylor","Jackson St",0,1,1,1
"749","Baylor","Kansas",6,1,0.142857142857143,7
"750","Baylor","Kansas St",3,3,0.5,6
"751","Baylor","Kentucky",0,2,1,2
"752","Baylor","Lamar",0,1,1,1
"753","Baylor","Lehigh",0,1,1,1
"754","Baylor","McNeese St",0,1,1,1
"755","Baylor","Memphis",0,1,1,1
"756","Baylor","New Mexico St",0,1,1,1
"757","Baylor","Norfolk St",0,1,1,1
"758","Baylor","Northwestern",1,0,0,1
"759","Baylor","Northwestern LA",0,1,1,1
"760","Baylor","Oklahoma",5,2,0.285714285714286,7
"761","Baylor","Oklahoma St",3,3,0.5,6
"762","Baylor","Oral Roberts",0,1,1,1
"763","Baylor","Prairie View",0,1,1,1
"764","Baylor","Savannah St",0,1,1,1
"765","Baylor","SC Upstate",0,1,1,1
"766","Baylor","SF Austin",0,1,1,1
"767","Baylor","South Carolina",0,2,1,2
"768","Baylor","Southern Univ",0,2,1,2
"769","Baylor","St John's",0,1,1,1
"770","Baylor","Syracuse",1,0,0,1
"771","Baylor","TCU",0,7,1,7
"772","Baylor","Texas",4,3,0.428571428571429,7
"773","Baylor","Texas A&M",0,1,1,1
"774","Baylor","Texas Tech",1,5,0.833333333333333,6
"775","Baylor","TX Southern",0,1,1,1
"776","Baylor","ULL",0,1,1,1
"777","Baylor","Vanderbilt",0,1,1,1
"778","Baylor","West Virginia",1,6,0.857142857142857,7
"779","Baylor","Chaminade",0,1,1,1
"780","Baylor","Hardin-Simmons",0,1,1,1
"781","Baylor","Huston-Tillot",0,1,1,1
"782","Belmont","Austin Peay",0,3,1,3
"783","Belmont","Boston Univ",0,1,1,1
"784","Belmont","Butler",1,0,0,1
"785","Belmont","Denver",1,1,0.5,2
"786","Belmont","Edwardsville",0,3,1,3
"787","Belmont","E Illinois",1,3,0.75,4
"788","Belmont","E Kentucky",3,5,0.625,8
"789","Belmont","Evansville",1,0,0,1
"790","Belmont","Fairfield",0,2,1,2
"791","Belmont","Hofstra",0,1,1,1
"792","Belmont","Holy Cross",0,1,1,1
"793","Belmont","Indiana St",1,1,0.5,2
"794","Belmont","Jacksonville St",1,5,0.833333333333333,6
"795","Belmont","Kansas",1,0,0,1
"796","Belmont","Kentucky",1,0,0,1
"797","Belmont","Lipscomb",0,6,1,6
"798","Belmont","Middle Tenn St",0,2,1,2
"799","Belmont","Morehead St",1,6,0.857142857142857,7
"800","Belmont","Murray St",2,2,0.5,4
"801","Belmont","North Carolina",0,1,1,1
"802","Belmont","Northeastern",1,0,0,1
"803","Belmont","Ohio",0,2,1,2
"804","Belmont","Oral Roberts",0,1,1,1
"805","Belmont","Richmond",1,0,0,1
"806","Belmont","S Dakota St",1,1,0.5,2
"807","Belmont","SE Missouri St",0,3,1,3
"808","Belmont","Stanford",0,1,1,1
"809","Belmont","Tennessee St",1,5,0.833333333333333,6
"810","Belmont","Tennessee Tech",1,5,0.833333333333333,6
"811","Belmont","TN Martin",0,3,1,3
"812","Belmont","UCF",1,0,0,1
"813","Belmont","VA Commonwealth",3,0,0,3
"814","Belmont","W Kentucky",0,1,1,1
"815","Belmont","Wright St",2,0,0,2
"816","Belmont","Brescia",0,1,1,1
"817","Belmont","MTSU",0,1,1,1
"818","Belmont","Trevecca Naz",0,1,1,1
"819","Bethune-Cookman","Akron",1,0,0,1
"820","Bethune-Cookman","Arizona St",1,0,0,1
"821","Bethune-Cookman","Ball St",1,0,0,1
"822","Bethune-Cookman","Central Conn",0,1,1,1
"823","Bethune-Cookman","Citadel",1,0,0,1
"824","Bethune-Cookman","Colorado St",1,0,0,1
"825","Bethune-Cookman","Coppin St",3,1,0.25,4
"826","Bethune-Cookman","Delaware St",2,1,0.333333333333333,3
"827","Bethune-Cookman","Detroit",1,0,0,1
"828","Bethune-Cookman","Florida A&M",2,4,0.666666666666667,6
"829","Bethune-Cookman","Florida Intl",2,0,0,2
"830","Bethune-Cookman","Hampton",3,0,0,3
"831","Bethune-Cookman","Howard",1,2,0.666666666666667,3
"832","Bethune-Cookman","Jacksonville",0,1,1,1
"833","Bethune-Cookman","Kent",1,0,0,1
"834","Bethune-Cookman","LSU",1,0,0,1
"835","Bethune-Cookman","MD E Shore",1,2,0.666666666666667,3
"836","Bethune-Cookman","Mercer",1,0,0,1
"837","Bethune-Cookman","Monmouth NJ",1,0,0,1
"838","Bethune-Cookman","Morgan St",1,1,0.5,2
"839","Bethune-Cookman","NC A&T",3,3,0.5,6
"840","Bethune-Cookman","NC Central",6,0,0,6
"841","Bethune-Cookman","N Colorado",1,0,0,1
"842","Bethune-Cookman","NE Omaha",0,1,1,1
"843","Bethune-Cookman","New Mexico St",1,0,0,1
"844","Bethune-Cookman","New Orleans",0,1,1,1
"845","Bethune-Cookman","N Illinois",1,0,0,1
"846","Bethune-Cookman","Norfolk St",3,0,0,3
"847","Bethune-Cookman","North Florida",3,0,0,3
"848","Bethune-Cookman","Pittsburgh",1,0,0,1
"849","Bethune-Cookman","Prairie View",1,0,0,1
"850","Bethune-Cookman","Savannah St",4,1,0.2,5
"851","Bethune-Cookman","S Carolina St",2,4,0.666666666666667,6
"852","Bethune-Cookman","South Florida",1,0,0,1
"853","Bethune-Cookman","St Bonaventure",1,0,0,1
"854","Bethune-Cookman","Stetson",2,1,0.333333333333333,3
"855","Bethune-Cookman","TN Martin",1,0,0,1
"856","Bethune-Cookman","Towson",1,0,0,1
"857","Bethune-Cookman","Tulane",1,0,0,1
"858","Bethune-Cookman","UCF",3,0,0,3
"859","Bethune-Cookman","Valparaiso",1,0,0,1
"860","Bethune-Cookman","Youngstown St",2,0,0,2
"861","Bethune-Cookman","Grand Canyon",1,0,0,1
"862","Bethune-Cookman","Trinity Bap",0,2,1,2
"863","Bethune-Cookman","Trinity FL",0,2,1,2
"864","Binghamton","Albany NY",6,0,0,6
"865","Binghamton","Army",2,0,0,2
"866","Binghamton","Boston College",1,0,0,1
"867","Binghamton","Boston Univ",3,0,0,3
"868","Binghamton","Brown",2,0,0,2
"869","Binghamton","Bryant",1,1,0.5,2
"870","Binghamton","Buffalo",2,0,0,2
"871","Binghamton","Colgate",3,0,0,3
"872","Binghamton","Cornell",2,1,0.333333333333333,3
"873","Binghamton","Hartford",7,0,0,7
"874","Binghamton","Loyola MD",2,0,0,2
"875","Binghamton","Maine",3,3,0.5,6
"876","Binghamton","Manhattan",1,0,0,1
"877","Binghamton","MD Baltimore Co",2,0,0,2
"878","Binghamton","Michigan",1,0,0,1
"879","Binghamton","Monmouth NJ",2,0,0,2
"880","Binghamton","Mt St Mary's",2,1,0.333333333333333,3
"881","Binghamton","Navy",3,0,0,3
"882","Binghamton","New Hampshire",4,2,0.333333333333333,6
"883","Binghamton","Notre Dame",1,0,0,1
"884","Binghamton","Penn",2,0,0,2
"885","Binghamton","Providence",1,0,0,1
"886","Binghamton","Radford",1,0,0,1
"887","Binghamton","St Bonaventure",1,0,0,1
"888","Binghamton","St Joseph's PA",1,0,0,1
"889","Binghamton","Stony Brook",7,0,0,7
"890","Binghamton","St Peter's",1,1,0.5,2
"891","Binghamton","Syracuse",1,0,0,1
"892","Binghamton","Vermont",5,1,0.166666666666667,6
"893","Binghamton","Caldwell",1,0,0,1
"894","Binghamton","MA Lowell",3,1,0.25,4
"895","Binghamton","UMBC",1,3,0.75,4
"896","Binghamton","Hartwick",0,1,1,1
"897","Boise St","Air Force",2,5,0.714285714285714,7
"898","Boise St","Colorado St",2,3,0.6,5
"899","Boise St","Creighton",0,1,1,1
"900","Boise St","Fresno St",2,4,0.666666666666667,6
"901","Boise St","Hawaii",0,1,1,1
"902","Boise St","Houston",0,1,1,1
"903","Boise St","Idaho",0,3,1,3
"904","Boise St","Iowa St",1,0,0,1
"905","Boise St","Kentucky",1,0,0,1
"906","Boise St","Loy Marymount",0,1,1,1
"907","Boise St","Loyola-Chicago",1,0,0,1
"908","Boise St","LSU",0,1,1,1
"909","Boise St","Michigan St",1,0,0,1
"910","Boise St","Montana",0,1,1,1
"911","Boise St","NC State",1,0,0,1
"912","Boise St","Nevada",2,4,0.666666666666667,6
"913","Boise St","New Mexico",4,3,0.428571428571429,7
"914","Boise St","New Orleans",0,2,1,2
"915","Boise St","Oakland",0,1,1,1
"916","Boise St","Portland St",0,1,1,1
"917","Boise St","San Diego",0,1,1,1
"918","Boise St","San Diego St",3,3,0.5,6
"919","Boise St","San Jose St",0,4,1,4
"920","Boise St","Santa Barbara",0,1,1,1
"921","Boise St","Seattle",0,2,1,2
"922","Boise St","South Carolina",0,1,1,1
"923","Boise St","Southern Utah",0,1,1,1
"924","Boise St","St Mary's CA",1,1,0.5,2
"925","Boise St","TX Southern",0,1,1,1
"926","Boise St","ULL",0,1,1,1
"927","Boise St","UNLV",3,4,0.571428571428571,7
"928","Boise St","Utah",1,1,0.5,2
"929","Boise St","Utah St",2,2,0.5,4
"930","Boise St","UT Arlington",0,2,1,2
"931","Boise St","Wisconsin",1,0,0,1
"932","Boise St","Wyoming",3,3,0.5,6
"933","Boise St","Abilene Chr",0,1,1,1
"934","Boise St","Carroll MT",0,1,1,1
"935","Boise St","NW Nazarene",0,1,1,1
"936","Boise St","Simpson CA",0,1,1,1
"937","Boise St","Adams St",0,1,1,1
"938","Boston College","Auburn",1,1,0.5,2
"939","Boston College","Baylor",1,0,0,1
"940","Boston College","Binghamton",0,1,1,1
"941","Boston College","Bryant",1,0,0,1
"942","Boston College","Clemson",2,2,0.5,4
"943","Boston College","Col Charleston",1,0,0,1
"944","Boston College","Connecticut",1,0,0,1
"945","Boston College","Dartmouth",0,1,1,1
"946","Boston College","Dayton",2,0,0,2
"947","Boston College","Duke",4,0,0,4
"948","Boston College","FL Atlantic",0,1,1,1
"949","Boston College","Florida Intl",0,1,1,1
"950","Boston College","Florida St",3,0,0,3
"951","Boston College","Georgia Tech",3,3,0.5,6
"952","Boston College","Harvard",2,1,0.333333333333333,3
"953","Boston College","Holy Cross",0,1,1,1
"954","Boston College","Louisville",1,0,0,1
"955","Boston College","Maine",0,1,1,1
"956","Boston College","Marist",0,1,1,1
"957","Boston College","Maryland",2,1,0.333333333333333,3
"958","Boston College","Massachusetts",2,0,0,2
"959","Boston College","Miami FL",5,0,0,5
"960","Boston College","NC State",3,1,0.25,4
"961","Boston College","New Hampshire",0,2,1,2
"962","Boston College","New Mexico",0,1,1,1
"963","Boston College","North Carolina",4,0,0,4
"964","Boston College","Notre Dame",4,0,0,4
"965","Boston College","Penn St",0,1,1,1
"966","Boston College","Pittsburgh",3,0,0,3
"967","Boston College","Providence",1,2,0.666666666666667,3
"968","Boston College","Purdue",1,0,0,1
"969","Boston College","Sacred Heart",0,1,1,1
"970","Boston College","St Francis NY",0,1,1,1
"971","Boston College","Syracuse",3,1,0.25,4
"972","Boston College","Toledo",1,0,0,1
"973","Boston College","USC",2,0,0,2
"974","Boston College","VA Commonwealth",1,0,0,1
"975","Boston College","Virginia",3,1,0.25,4
"976","Boston College","Virginia Tech",0,4,1,4
"977","Boston College","Wake Forest",1,3,0.75,4
"978","Boston College","Washington",0,1,1,1
"979","Boston College","West Virginia",1,0,0,1
"980","Boston College","MA Lowell",0,1,1,1
"981","Boston College","Philadelphia",0,1,1,1
"982","Boston Univ","Albany NY",0,2,1,2
"983","Boston Univ","American Univ",2,3,0.6,5
"984","Boston Univ","Army",1,4,0.8,5
"985","Boston Univ","Belmont",1,0,0,1
"986","Boston Univ","Binghamton",0,3,1,3
"987","Boston Univ","Bucknell",3,1,0.25,4
"988","Boston Univ","Canisius",1,0,0,1
"989","Boston Univ","Coastal Car",0,2,1,2
"990","Boston Univ","Colgate",2,2,0.5,4
"991","Boston Univ","Connecticut",1,0,0,1
"992","Boston Univ","Cornell",0,1,1,1
"993","Boston Univ","Dayton",1,0,0,1
"994","Boston Univ","E Washington",1,0,0,1
"995","Boston Univ","George Mason",1,0,0,1
"996","Boston Univ","G Washington",2,0,0,2
"997","Boston Univ","Hartford",2,0,0,2
"998","Boston Univ","Harvard",3,0,0,3
"999","Boston Univ","Holy Cross",1,3,0.75,4
"1000","Boston Univ","Howard",0,1,1,1
"1001","Boston Univ","Kentucky",1,0,0,1
"1002","Boston Univ","Lafayette",2,4,0.666666666666667,6
"1003","Boston Univ","Lehigh",2,2,0.5,4
"1004","Boston Univ","Long Island",0,1,1,1
"1005","Boston Univ","Loyola MD",1,3,0.75,4
"1006","Boston Univ","Maine",1,1,0.5,2
"1007","Boston Univ","Maryland",0,1,1,1
"1008","Boston Univ","MD Baltimore Co",0,2,1,2
"1009","Boston Univ","Navy",0,4,1,4
"1010","Boston Univ","New Hampshire",1,2,0.666666666666667,3
"1011","Boston Univ","Norfolk St",1,1,0.5,2
"1012","Boston Univ","Northeastern",2,1,0.333333333333333,3
"1013","Boston Univ","Quinnipiac",0,3,1,3
"1014","Boston Univ","Rutgers",1,0,0,1
"1015","Boston Univ","St Joseph's PA",1,0,0,1
"1016","Boston Univ","Stony Brook",2,0,0,2
"1017","Boston Univ","St Peter's",1,2,0.666666666666667,3
"1018","Boston Univ","UC Irvine",0,1,1,1
"1019","Boston Univ","Vermont",0,2,1,2
"1020","Boston Univ","MA Lowell",1,1,0.5,2
"1021","Boston Univ","Wentworth Tech",0,1,1,1
"1022","Bowling Green","Akron",6,0,0,6
"1023","Bowling Green","Alabama A&M",0,1,1,1
"1024","Bowling Green","Ball St",0,5,1,5
"1025","Bowling Green","Buffalo",4,3,0.428571428571429,7
"1026","Bowling Green","Chicago St",0,1,1,1
"1027","Bowling Green","Cleveland St",1,1,0.5,2
"1028","Bowling Green","C Michigan",1,2,0.666666666666667,3
"1029","Bowling Green","Dayton",1,0,0,1
"1030","Bowling Green","Detroit",0,3,1,3
"1031","Bowling Green","Drake",0,1,1,1
"1032","Bowling Green","E Michigan",3,2,0.4,5
"1033","Bowling Green","IPFW",2,0,0,2
"1034","Bowling Green","IUPUI",1,0,0,1
"1035","Bowling Green","Kent",3,3,0.5,6
"1036","Bowling Green","Miami OH",4,2,0.333333333333333,6
"1037","Bowling Green","Michigan St",1,0,0,1
"1038","Bowling Green","Morehead St",0,1,1,1
"1039","Bowling Green","New Orleans",0,1,1,1
"1040","Bowling Green","N Illinois",2,3,0.6,5
"1041","Bowling Green","North Dakota",1,1,0.5,2
"1042","Bowling Green","Ohio",3,3,0.5,6
"1043","Bowling Green","Oral Roberts",1,0,0,1
"1044","Bowling Green","Presbyterian",0,1,1,1
"1045","Bowling Green","Robert Morris",1,0,0,1
"1046","Bowling Green","Samford",0,1,1,1
"1047","Bowling Green","SE Missouri St",0,1,1,1
"1048","Bowling Green","South Florida",2,1,0.333333333333333,3
"1049","Bowling Green","St Louis",1,0,0,1
"1050","Bowling Green","Temple",1,0,0,1
"1051","Bowling Green","Toledo",4,0,0,4
"1052","Bowling Green","Wisconsin",1,0,0,1
"1053","Bowling Green","W Kentucky",1,1,0.5,2
"1054","Bowling Green","W Michigan",0,3,1,3
"1055","Bowling Green","Wright St",1,2,0.666666666666667,3
"1056","Bowling Green","Xavier",1,0,0,1
"1057","Bowling Green","Youngstown St",1,0,0,1
"1058","Bowling Green","Earlham",0,1,1,1
"1059","Bowling Green","Ferris St",1,0,0,1
"1060","Bradley","Alabama St",0,1,1,1
"1061","Bradley","Arizona St",1,0,0,1
"1062","Bradley","Ark Little Rock",1,0,0,1
"1063","Bradley","Chicago St",0,1,1,1
"1064","Bradley","C Michigan",0,3,1,3
"1065","Bradley","Creighton",2,0,0,2
"1066","Bradley","Drake",4,3,0.428571428571429,7
"1067","Bradley","E Illinois",0,1,1,1
"1068","Bradley","Evansville",3,3,0.5,6
"1069","Bradley","Ga Southern",0,1,1,1
"1070","Bradley","G Washington",0,1,1,1
"1071","Bradley","IL Chicago",0,2,1,2
"1072","Bradley","Illinois",1,0,0,1
"1073","Bradley","Illinois St",4,2,0.333333333333333,6
"1074","Bradley","Indiana St",5,1,0.166666666666667,6
"1075","Bradley","IPFW",1,0,0,1
"1076","Bradley","IUPUI",1,1,0.5,2
"1077","Bradley","Jacksonville St",0,1,1,1
"1078","Bradley","Kansas St",1,0,0,1
"1079","Bradley","Loyola-Chicago",3,2,0.4,5
"1080","Bradley","Memphis",1,0,0,1
"1081","Bradley","Michigan",1,0,0,1
"1082","Bradley","Missouri St",4,2,0.333333333333333,6
"1083","Bradley","MS Valley St",0,1,1,1
"1084","Bradley","NC A&T",0,1,1,1
"1085","Bradley","Northern Iowa",6,1,0.142857142857143,7
"1086","Bradley","Pacific",1,0,0,1
"1087","Bradley","Portland",2,0,0,2
"1088","Bradley","Robert Morris",1,0,0,1
"1089","Bradley","S Illinois",2,4,0.666666666666667,6
"1090","Bradley","South Florida",2,0,0,2
"1091","Bradley","St Louis",1,0,0,1
"1092","Bradley","TAM C. Christi",0,1,1,1
"1093","Bradley","TCU",1,0,0,1
"1094","Bradley","TN Martin",0,1,1,1
"1095","Bradley","TX Pan American",0,2,1,2
"1096","Bradley","UC Irvine",1,0,0,1
"1097","Bradley","UT Arlington",1,0,0,1
"1098","Bradley","Virginia Tech",1,0,0,1
"1099","Bradley","Wichita St",6,0,0,6
"1100","Bradley","WI Milwaukee",1,0,0,1
"1101","Bradley","Eureka",0,1,1,1
"1102","Brown","Albany NY",2,0,0,2
"1103","Brown","American Univ",1,1,0.5,2
"1104","Brown","Austin Peay",1,0,0,1
"1105","Brown","Binghamton",0,2,1,2
"1106","Brown","Bryant",2,1,0.333333333333333,3
"1107","Brown","Central Conn",1,2,0.666666666666667,3
"1108","Brown","Columbia",3,3,0.5,6
"1109","Brown","Cornell",2,4,0.666666666666667,6
"1110","Brown","Dartmouth",2,4,0.666666666666667,6
"1111","Brown","Harvard",6,0,0,6
"1112","Brown","Holy Cross",1,0,0,1
"1113","Brown","Illinois",1,0,0,1
"1114","Brown","Indiana St",1,0,0,1
"1115","Brown","Longwood",0,1,1,1
"1116","Brown","Maine",0,1,1,1
"1117","Brown","New Hampshire",2,1,0.333333333333333,3
"1118","Brown","Niagara",1,1,0.5,2
"1119","Brown","Northwestern",3,0,0,3
"1120","Brown","Notre Dame",1,0,0,1
"1121","Brown","Penn",2,4,0.666666666666667,6
"1122","Brown","Prairie View",0,1,1,1
"1123","Brown","Princeton",5,1,0.166666666666667,6
"1124","Brown","Providence",1,2,0.666666666666667,3
"1125","Brown","Rhode Island",3,0,0,3
"1126","Brown","Sacred Heart",0,3,1,3
"1127","Brown","St Francis NY",1,0,0,1
"1128","Brown","St Peter's",0,1,1,1
"1129","Brown","Yale",4,2,0.333333333333333,6
"1130","Brown","Daniel Webster",0,1,1,1
"1131","Brown","Lyndon St",0,1,1,1
"1132","Brown","MA Lowell",0,2,1,2
"1133","Brown","J&W RI",0,1,1,1
"1134","Bryant","Akron",1,0,0,1
"1135","Bryant","Army",0,2,1,2
"1136","Bryant","Binghamton",1,1,0.5,2
"1137","Bryant","Boston College",0,1,1,1
"1138","Bryant","Brown",1,2,0.666666666666667,3
"1139","Bryant","Central Conn",0,6,1,6
"1140","Bryant","Connecticut",1,0,0,1
"1141","Bryant","Dartmouth",1,2,0.666666666666667,3
"1142","Bryant","Delaware",1,0,0,1
"1143","Bryant","Denver",0,1,1,1
"1144","Bryant","F Dickinson",1,4,0.8,5
"1145","Bryant","Gonzaga",1,0,0,1
"1146","Bryant","Harvard",2,0,0,2
"1147","Bryant","Indiana",1,0,0,1
"1148","Bryant","Lehigh",0,2,1,2
"1149","Bryant","Long Island",1,4,0.8,5
"1150","Bryant","Monmouth NJ",0,1,1,1
"1151","Bryant","Mt St Mary's",4,3,0.428571428571429,7
"1152","Bryant","Navy",1,1,0.5,2
"1153","Bryant","N Dakota St",1,0,0,1
"1154","Bryant","New Hampshire",0,3,1,3
"1155","Bryant","Notre Dame",1,0,0,1
"1156","Bryant","Ohio St",1,0,0,1
"1157","Bryant","Pittsburgh",1,0,0,1
"1158","Bryant","Providence",1,0,0,1
"1159","Bryant","Quinnipiac",1,1,0.5,2
"1160","Bryant","Robert Morris",5,2,0.285714285714286,7
"1161","Bryant","Sacred Heart",3,4,0.571428571428571,7
"1162","Bryant","St Francis NY",2,3,0.6,5
"1163","Bryant","St Francis PA",2,4,0.666666666666667,6
"1164","Bryant","Vermont",1,1,0.5,2
"1165","Bryant","Wagner",2,3,0.6,5
"1166","Bryant","Yale",2,1,0.333333333333333,3
"1167","Bryant","Salve Regina",0,1,1,1
"1168","Bucknell","Albany NY",0,2,1,2
"1169","Bucknell","American Univ",1,5,0.833333333333333,6
"1170","Bucknell","Army",2,6,0.75,8
"1171","Bucknell","Boston Univ",1,3,0.75,4
"1172","Bucknell","Colgate",2,4,0.666666666666667,6
"1173","Bucknell","Columbia",1,2,0.666666666666667,3
"1174","Bucknell","Cornell",0,1,1,1
"1175","Bucknell","Dartmouth",0,1,1,1
"1176","Bucknell","Fairfield",1,1,0.5,2
"1177","Bucknell","George Mason",0,1,1,1
"1178","Bucknell","Holy Cross",2,5,0.714285714285714,7
"1179","Bucknell","Kent",0,2,1,2
"1180","Bucknell","Lafayette",4,3,0.428571428571429,7
"1181","Bucknell","La Salle",0,1,1,1
"1182","Bucknell","Lehigh",3,3,0.5,6
"1183","Bucknell","Loyola MD",0,5,1,5
"1184","Bucknell","Marist",1,2,0.666666666666667,3
"1185","Bucknell","MD E Shore",0,1,1,1
"1186","Bucknell","Michigan",1,0,0,1
"1187","Bucknell","Missouri",1,0,0,1
"1188","Bucknell","Mt St Mary's",2,0,0,2
"1189","Bucknell","Navy",1,6,0.857142857142857,7
"1190","Bucknell","New Mexico St",0,1,1,1
"1191","Bucknell","Niagara",0,1,1,1
"1192","Bucknell","Penn St",2,1,0.333333333333333,3
"1193","Bucknell","Princeton",2,0,0,2
"1194","Bucknell","Purdue",0,1,1,1
"1195","Bucknell","Siena",1,0,0,1
"1196","Bucknell","Stanford",1,0,0,1
"1197","Bucknell","St Francis PA",0,2,1,2
"1198","Bucknell","St John's",1,0,0,1
"1199","Bucknell","Toledo",1,0,0,1
"1200","Bucknell","Villanova",1,0,0,1
"1201","Bucknell","Wake Forest",1,0,0,1
"1202","Bucknell","Case Western",0,1,1,1
"1203","Buffalo","Akron",3,4,0.571428571428571,7
"1204","Buffalo","Ball St",1,3,0.75,4
"1205","Buffalo","Binghamton",0,2,1,2
"1206","Buffalo","Bowling Green",3,4,0.571428571428571,7
"1207","Buffalo","Canisius",2,1,0.333333333333333,3
"1208","Buffalo","C Michigan",2,3,0.6,5
"1209","Buffalo","Cornell",0,1,1,1
"1210","Buffalo","Delaware St",0,1,1,1
"1211","Buffalo","Drexel",0,2,1,2
"1212","Buffalo","E Michigan",2,2,0.5,4
"1213","Buffalo","Evansville",0,1,1,1
"1214","Buffalo","Florida St",1,0,0,1
"1215","Buffalo","Kent",2,4,0.666666666666667,6
"1216","Buffalo","Kentucky",1,0,0,1
"1217","Buffalo","Manhattan",2,0,0,2
"1218","Buffalo","Miami OH",1,5,0.833333333333333,6
"1219","Buffalo","Niagara",1,2,0.666666666666667,3
"1220","Buffalo","N Illinois",0,4,1,4
"1221","Buffalo","Ohio",4,2,0.333333333333333,6
"1222","Buffalo","Princeton",1,0,0,1
"1223","Buffalo","Robert Morris",0,2,1,2
"1224","Buffalo","S Dakota St",0,1,1,1
"1225","Buffalo","St Bonaventure",2,1,0.333333333333333,3
"1226","Buffalo","Temple",1,0,0,1
"1227","Buffalo","Texas A&M",1,0,0,1
"1228","Buffalo","Toledo",2,1,0.333333333333333,3
"1229","Buffalo","Tulsa",1,0,0,1
"1230","Buffalo","UT Arlington",0,1,1,1
"1231","Buffalo","Washington St",1,0,0,1
"1232","Buffalo","W Illinois",1,0,0,1
"1233","Buffalo","WI Milwaukee",0,1,1,1
"1234","Buffalo","Wisconsin",1,0,0,1
"1235","Buffalo","W Michigan",2,2,0.5,4
"1236","Buffalo","Yale",1,0,0,1
"1237","Buffalo","Grand Canyon",0,1,1,1
"1238","Buffalo","WV Wesleyan",0,1,1,1
"1239","Butler","Ball St",0,2,1,2
"1240","Butler","Belmont",0,1,1,1
"1241","Butler","Charlotte",1,0,0,1
"1242","Butler","Chattanooga",0,1,1,1
"1243","Butler","Creighton",2,2,0.5,4
"1244","Butler","Dayton",0,1,1,1
"1245","Butler","DePaul",1,3,0.75,4
"1246","Butler","Duquesne",0,1,1,1
"1247","Butler","Elon",0,1,1,1
"1248","Butler","Evansville",0,2,1,2
"1249","Butler","Fordham",0,1,1,1
"1250","Butler","Georgetown",4,1,0.2,5
"1251","Butler","Gonzaga",0,1,1,1
"1252","Butler","G Washington",0,1,1,1
"1253","Butler","Illinois",1,0,0,1
"1254","Butler","Indiana",1,1,0.5,2
"1255","Butler","Indiana St",0,1,1,1
"1256","Butler","IUPUI",0,1,1,1
"1257","Butler","Kennesaw",0,1,1,1
"1258","Butler","Lamar",0,1,1,1
"1259","Butler","La Salle",1,0,0,1
"1260","Butler","Loyola MD",0,1,1,1
"1261","Butler","LSU",1,0,0,1
"1262","Butler","Maine",0,1,1,1
"1263","Butler","Marquette",1,4,0.8,5
"1264","Butler","Massachusetts",0,1,1,1
"1265","Butler","New Orleans",0,1,1,1
"1266","Butler","NJIT",0,1,1,1
"1267","Butler","North Carolina",0,2,1,2
"1268","Butler","North Dakota",0,1,1,1
"1269","Butler","Northwestern",0,2,1,2
"1270","Butler","Oklahoma",1,0,0,1
"1271","Butler","Oklahoma St",1,0,0,1
"1272","Butler","Penn",0,1,1,1
"1273","Butler","Princeton",0,1,1,1
"1274","Butler","Providence",3,1,0.25,4
"1275","Butler","Purdue",0,1,1,1
"1276","Butler","Rhode Island",0,1,1,1
"1277","Butler","Richmond",0,1,1,1
"1278","Butler","Seton Hall",1,4,0.8,5
"1279","Butler","St Bonaventure",0,1,1,1
"1280","Butler","St John's",2,2,0.5,4
"1281","Butler","St Joseph's PA",0,1,1,1
"1282","Butler","St Louis",2,0,0,2
"1283","Butler","Temple",0,1,1,1
"1284","Butler","Tennessee",1,0,0,1
"1285","Butler","TN Martin",0,1,1,1
"1286","Butler","VA Commonwealth",1,0,0,1
"1287","Butler","Vanderbilt",0,2,1,2
"1288","Butler","Villanova",4,0,0,4
"1289","Butler","Washington St",0,1,1,1
"1290","Butler","Xavier",5,2,0.285714285714286,7
"1291","Butler","Manchester",0,1,1,1
"1292","BYU","Ark Little Rock",0,1,1,1
"1293","BYU","Baylor",1,0,0,1
"1294","BYU","CS Northridge",0,1,1,1
"1295","BYU","E Kentucky",0,1,1,1
"1296","BYU","Florida St",1,0,0,1
"1297","BYU","Georgia St",0,1,1,1
"1298","BYU","Gonzaga",6,2,0.25,8
"1299","BYU","Hawaii",0,1,1,1
"1300","BYU","Iowa St",2,0,0,2
"1301","BYU","Long Beach St",0,1,1,1
"1302","BYU","Loy Marymount",1,6,0.857142857142857,7
"1303","BYU","Massachusetts",1,1,0.5,2
"1304","BYU","Montana",0,1,1,1
"1305","BYU","Mt St Mary's",0,1,1,1
"1306","BYU","Northern Arizona",0,1,1,1
"1307","BYU","North Texas",0,1,1,1
"1308","BYU","Notre Dame",1,0,0,1
"1309","BYU","Oregon",1,0,0,1
"1310","BYU","Pacific",1,3,0.75,4
"1311","BYU","Pepperdine",3,3,0.5,6
"1312","BYU","Portland",1,6,0.857142857142857,7
"1313","BYU","Prairie View",0,1,1,1
"1314","BYU","Purdue",1,0,0,1
"1315","BYU","San Diego",2,4,0.666666666666667,6
"1316","BYU","San Diego St",1,0,0,1
"1317","BYU","San Francisco",1,6,0.857142857142857,7
"1318","BYU","Santa Clara",0,7,1,7
"1319","BYU","Stanford",0,2,1,2
"1320","BYU","St Mary's CA",3,3,0.5,6
"1321","BYU","Tennessee St",0,1,1,1
"1322","BYU","Texas",0,1,1,1
"1323","BYU","Utah",2,1,0.333333333333333,3
"1324","BYU","Utah St",0,3,1,3
"1325","BYU","UT San Antonio",0,1,1,1
"1326","BYU","Virginia Tech",0,1,1,1
"1327","BYU","Weber St",0,3,1,3
"1328","BYU","Wichita St",1,0,0,1
"1329","BYU","Chaminade",0,1,1,1
"1330","BYU","Mesa St",0,1,1,1
"1331","BYU","S Virginia",0,1,1,1
"1332","California","Alcorn St",0,1,1,1
"1333","California","Arizona",4,2,0.333333333333333,6
"1334","California","Arizona St",5,0,0,5
"1335","California","Arkansas",0,1,1,1
"1336","California","Cal Poly SLO",0,1,1,1
"1337","California","Colorado",2,3,0.6,5
"1338","California","Coppin St",0,1,1,1
"1339","California","Creighton",2,0,0,2
"1340","California","CS Bakersfield",1,1,0.5,2
"1341","California","Dayton",1,0,0,1
"1342","California","Denver",0,2,1,2
"1343","California","Drake",0,1,1,1
"1344","California","E Washington",0,1,1,1
"1345","California","Fresno St",0,2,1,2
"1346","California","Furman",0,1,1,1
"1347","California","Georgia Tech",0,1,1,1
"1348","California","Harvard",1,0,0,1
"1349","California","Kennesaw",0,1,1,1
"1350","California","Montana",0,1,1,1
"1351","California","Nevada",0,2,1,2
"1352","California","Oakland",0,1,1,1
"1353","California","Oregon",1,3,0.75,4
"1354","California","Oregon St",0,4,1,4
"1355","California","Pacific",0,1,1,1
"1356","California","Pepperdine",0,1,1,1
"1357","California","Prairie View",0,1,1,1
"1358","California","Princeton",0,1,1,1
"1359","California","Santa Barbara",1,1,0.5,2
"1360","California","Southern Utah",0,1,1,1
"1361","California","Stanford",5,1,0.166666666666667,6
"1362","California","Syracuse",1,1,0.5,2
"1363","California","Texas",1,0,0,1
"1364","California","UC Irvine",0,1,1,1
"1365","California","UCLA",4,2,0.333333333333333,6
"1366","California","UNLV",1,0,0,1
"1367","California","USC",2,4,0.666666666666667,6
"1368","California","Utah",2,2,0.5,4
"1369","California","Washington",1,4,0.8,5
"1370","California","Washington St",1,5,0.833333333333333,6
"1371","California","Wisconsin",2,0,0,2
"1372","California","Wyoming",0,1,1,1
"1373","Cal Poly SLO","Arizona",1,0,0,1
"1374","Cal Poly SLO","California",1,0,0,1
"1375","Cal Poly SLO","CS Fullerton",2,4,0.666666666666667,6
"1376","Cal Poly SLO","CS Northridge",1,6,0.857142857142857,7
"1377","Cal Poly SLO","Delaware",1,1,0.5,2
"1378","Cal Poly SLO","Fresno St",3,0,0,3
"1379","Cal Poly SLO","Gonzaga",1,0,0,1
"1380","Cal Poly SLO","Hawaii",2,4,0.666666666666667,6
"1381","Cal Poly SLO","IPFW",0,1,1,1
"1382","Cal Poly SLO","Long Beach St",4,2,0.333333333333333,6
"1383","Cal Poly SLO","Loy Marymount",1,1,0.5,2
"1384","Cal Poly SLO","N Colorado",0,1,1,1
"1385","Cal Poly SLO","Nevada",3,0,0,3
"1386","Cal Poly SLO","North Dakota",0,1,1,1
"1387","Cal Poly SLO","Northeastern",0,1,1,1
"1388","Cal Poly SLO","Oregon",1,0,0,1
"1389","Cal Poly SLO","Pacific",2,1,0.333333333333333,3
"1390","Cal Poly SLO","Pittsburgh",1,0,0,1
"1391","Cal Poly SLO","San Francisco",0,1,1,1
"1392","Cal Poly SLO","Santa Barbara",5,3,0.375,8
"1393","Cal Poly SLO","Santa Clara",1,2,0.666666666666667,3
"1394","Cal Poly SLO","Stanford",1,0,0,1
"1395","Cal Poly SLO","St Mary's CA",2,0,0,2
"1396","Cal Poly SLO","TCU",1,0,0,1
"1397","Cal Poly SLO","UC Davis",5,1,0.166666666666667,6
"1398","Cal Poly SLO","UC Irvine",5,2,0.285714285714286,7
"1399","Cal Poly SLO","UCLA",0,1,1,1
"1400","Cal Poly SLO","UC Riverside",2,4,0.666666666666667,6
"1401","Cal Poly SLO","Washington",1,0,0,1
"1402","Cal Poly SLO","Bethesda",0,1,1,1
"1403","Cal Poly SLO","CS Dom. Hills",0,1,1,1
"1404","Cal Poly SLO","Menlo",0,1,1,1
"1405","Cal Poly SLO","S Francisco St",0,1,1,1
"1406","Campbell","Appalachian St",0,2,1,2
"1407","Campbell","Charleston So",4,1,0.2,5
"1408","Campbell","Cincinnati",2,0,0,2
"1409","Campbell","Coastal Car",4,0,0,4
"1410","Campbell","Col Charleston",1,0,0,1
"1411","Campbell","Colgate",1,0,0,1
"1412","Campbell","Davidson",1,0,0,1
"1413","Campbell","Delaware St",1,1,0.5,2
"1414","Campbell","East Carolina",1,1,0.5,2
"1415","Campbell","Edwardsville",0,1,1,1
"1416","Campbell","Gardner Webb",3,2,0.4,5
"1417","Campbell","Ga Southern",0,2,1,2
"1418","Campbell","Gonzaga",1,0,0,1
"1419","Campbell","High Point",5,1,0.166666666666667,6
"1420","Campbell","Iowa St",1,0,0,1
"1421","Campbell","James Madison",1,0,0,1
"1422","Campbell","Liberty",5,1,0.166666666666667,6
"1423","Campbell","Longwood",3,2,0.4,5
"1424","Campbell","Loyola-Chicago",1,0,0,1
"1425","Campbell","NC A&T",1,0,0,1
"1426","Campbell","NC Central",1,0,0,1
"1427","Campbell","NC State",1,0,0,1
"1428","Campbell","Northern Arizona",1,0,0,1
"1429","Campbell","Northwestern LA",1,0,0,1
"1430","Campbell","Ohio St",1,0,0,1
"1431","Campbell","Presbyterian",1,3,0.75,4
"1432","Campbell","Radford",2,3,0.6,5
"1433","Campbell","Robert Morris",2,0,0,2
"1434","Campbell","Sacred Heart",1,0,0,1
"1435","Campbell","Samford",1,0,0,1
"1436","Campbell","Savannah St",1,0,0,1
"1437","Campbell","Seattle",1,0,0,1
"1438","Campbell","UNC Asheville",4,0,0,4
"1439","Campbell","UNC Wilmington",1,2,0.666666666666667,3
"1440","Campbell","VMI",2,2,0.5,4
"1441","Campbell","Winthrop",2,2,0.5,4
"1442","Campbell","Barber-Scotia",0,1,1,1
"1443","Campbell","Chowan",1,0,0,1
"1444","Campbell","J&W NC",0,2,1,2
"1445","Campbell","Montreat And",0,1,1,1
"1446","Campbell","Shenandoah",0,1,1,1
"1447","Campbell","St Andrew's",0,1,1,1
"1448","Canisius","Alcorn St",0,1,1,1
"1449","Canisius","Boston Univ",0,1,1,1
"1450","Canisius","Buffalo",1,2,0.666666666666667,3
"1451","Canisius","Cornell",1,0,0,1
"1452","Canisius","Detroit",1,0,0,1
"1453","Canisius","Elon",0,1,1,1
"1454","Canisius","Fairfield",1,5,0.833333333333333,6
"1455","Canisius","Georgia St",0,1,1,1
"1456","Canisius","Holy Cross",0,2,1,2
"1457","Canisius","Iona",4,3,0.428571428571429,7
"1458","Canisius","Lamar",0,1,1,1
"1459","Canisius","Lehigh",0,1,1,1
"1460","Canisius","Longwood",0,1,1,1
"1461","Canisius","Loyola MD",1,1,0.5,2
"1462","Canisius","Manhattan",5,1,0.166666666666667,6
"1463","Canisius","Marist",2,4,0.666666666666667,6
"1464","Canisius","Massachusetts",1,0,0,1
"1465","Canisius","MD Baltimore Co",0,1,1,1
"1466","Canisius","Missouri KC",0,1,1,1
"1467","Canisius","Monmouth NJ",4,1,0.2,5
"1468","Canisius","Niagara",2,4,0.666666666666667,6
"1469","Canisius","Notre Dame",1,0,0,1
"1470","Canisius","Quinnipiac",1,3,0.75,4
"1471","Canisius","Rider",3,3,0.5,6
"1472","Canisius","Rutgers",1,0,0,1
"1473","Canisius","Siena",1,6,0.857142857142857,7
"1474","Canisius","South Dakota",0,1,1,1
"1475","Canisius","St Bonaventure",2,1,0.333333333333333,3
"1476","Canisius","St Francis NY",1,0,0,1
"1477","Canisius","Stony Brook",1,1,0.5,2
"1478","Canisius","St Peter's",0,6,1,6
"1479","Canisius","Syracuse",1,0,0,1
"1480","Canisius","Temple",0,1,1,1
"1481","Canisius","UNLV",1,0,0,1
"1482","Canisius","Vermont",1,1,0.5,2
"1483","Canisius","Metro St",1,0,0,1
"1484","Cent Arkansas","Arizona St",1,0,0,1
"1485","Cent Arkansas","Arkansas St",3,0,0,3
"1486","Cent Arkansas","Ark Little Rock",1,0,0,1
"1487","Cent Arkansas","Charleston So",2,0,0,2
"1488","Cent Arkansas","Coastal Car",1,0,0,1
"1489","Cent Arkansas","Creighton",1,0,0,1
"1490","Cent Arkansas","CS Sacramento",1,0,0,1
"1491","Cent Arkansas","Edwardsville",1,1,0.5,2
"1492","Cent Arkansas","E Illinois",0,1,1,1
"1493","Cent Arkansas","Houston Bap",2,1,0.333333333333333,3
"1494","Cent Arkansas","Kansas St",1,0,0,1
"1495","Cent Arkansas","Lamar",1,3,0.75,4
"1496","Cent Arkansas","Louisiana Tech",1,0,0,1
"1497","Cent Arkansas","McNeese St",2,3,0.6,5
"1498","Cent Arkansas","Mississippi St",1,0,0,1
"1499","Cent Arkansas","Morehead St",1,0,0,1
"1500","Cent Arkansas","Nebraska",1,0,0,1
"1501","Cent Arkansas","NE Omaha",2,0,0,2
"1502","Cent Arkansas","New Mexico",1,0,0,1
"1503","Cent Arkansas","New Orleans",2,1,0.333333333333333,3
"1504","Cent Arkansas","Nicholls St",4,1,0.2,5
"1505","Cent Arkansas","North Texas",1,0,0,1
"1506","Cent Arkansas","Northwestern LA",6,0,0,6
"1507","Cent Arkansas","Oklahoma St",1,0,0,1
"1508","Cent Arkansas","Oral Roberts",3,1,0.25,4
"1509","Cent Arkansas","Sam Houston St",4,1,0.2,5
"1510","Cent Arkansas","SE Louisiana",3,2,0.4,5
"1511","Cent Arkansas","SE Missouri St",1,1,0.5,2
"1512","Cent Arkansas","SF Austin",5,0,0,5
"1513","Cent Arkansas","TAM C. Christi",4,1,0.2,5
"1514","Cent Arkansas","Texas Tech",1,0,0,1
"1515","Cent Arkansas","TN Martin",0,1,1,1
"1516","Cent Arkansas","Troy",1,1,0.5,2
"1517","Cent Arkansas","Abilene Chr",2,0,0,2
"1518","Cent Arkansas","Ecclesia",0,1,1,1
"1519","Cent Arkansas","Hendrix",0,1,1,1
"1520","Cent Arkansas","Incarnate Word",2,0,0,2
"1521","Central Conn","Bethune-Cookman",1,0,0,1
"1522","Central Conn","Brown",2,1,0.333333333333333,3
"1523","Central Conn","Bryant",6,0,0,6
"1524","Central Conn","Coastal Car",2,0,0,2
"1525","Central Conn","Connecticut",1,0,0,1
"1526","Central Conn","East Carolina",1,0,0,1
"1527","Central Conn","Fairfield",2,0,0,2
"1528","Central Conn","F Dickinson",3,2,0.4,5
"1529","Central Conn","Hartford",1,2,0.666666666666667,3
"1530","Central Conn","Hofstra",2,0,0,2
"1531","Central Conn","Indiana",1,0,0,1
"1532","Central Conn","La Salle",0,1,1,1
"1533","Central Conn","Long Island",4,1,0.2,5
"1534","Central Conn","Maryland",1,0,0,1
"1535","Central Conn","MD Baltimore Co",0,1,1,1
"1536","Central Conn","Monmouth NJ",1,1,0.5,2
"1537","Central Conn","Mt St Mary's",5,0,0,5
"1538","Central Conn","New Hampshire",0,2,1,2
"1539","Central Conn","NJIT",1,1,0.5,2
"1540","Central Conn","Northeastern",2,0,0,2
"1541","Central Conn","Ohio St",1,0,0,1
"1542","Central Conn","Purdue",1,0,0,1
"1543","Central Conn","Quinnipiac",1,1,0.5,2
"1544","Central Conn","Rider",2,0,0,2
"1545","Central Conn","Robert Morris",3,2,0.4,5
"1546","Central Conn","Sacred Heart",1,5,0.833333333333333,6
"1547","Central Conn","St Francis NY",3,2,0.4,5
"1548","Central Conn","St Francis PA",4,2,0.333333333333333,6
"1549","Central Conn","St Peter's",2,0,0,2
"1550","Central Conn","Syracuse",1,0,0,1
"1551","Central Conn","Towson",1,0,0,1
"1552","Central Conn","Wagner",5,3,0.375,8
"1553","Central Conn","Yale",1,0,0,1
"1554","Central Conn","Albertus Magnus",0,1,1,1
"1555","Central Conn","UMBC",0,1,1,1
"1556","Charleston So","Alabama",2,0,0,2
"1557","Charleston So","Arizona",1,0,0,1
"1558","Charleston So","Baylor",1,0,0,1
"1559","Charleston So","Campbell",1,4,0.8,5
"1560","Charleston So","Cent Arkansas",0,2,1,2
"1561","Charleston So","Charlotte",1,0,0,1
"1562","Charleston So","Citadel",0,1,1,1
"1563","Charleston So","Coastal Car",4,3,0.428571428571429,7
"1564","Charleston So","Col Charleston",1,0,0,1
"1565","Charleston So","Colorado St",1,0,0,1
"1566","Charleston So","Delaware",1,1,0.5,2
"1567","Charleston So","ETSU",1,1,0.5,2
"1568","Charleston So","Florida St",2,0,0,2
"1569","Charleston So","Gardner Webb",4,2,0.333333333333333,6
"1570","Charleston So","High Point",2,2,0.5,4
"1571","Charleston So","Liberty",0,4,1,4
"1572","Charleston So","Longwood",2,3,0.6,5
"1573","Charleston So","Mississippi",0,1,1,1
"1574","Charleston So","NC State",1,0,0,1
"1575","Charleston So","New Mexico",1,0,0,1
"1576","Charleston So","Presbyterian",0,6,1,6
"1577","Charleston So","Radford",2,2,0.5,4
"1578","Charleston So","Rider",1,0,0,1
"1579","Charleston So","UNC Asheville",2,3,0.6,5
"1580","Charleston So","UNC Wilmington",1,0,0,1
"1581","Charleston So","VMI",1,1,0.5,2
"1582","Charleston So","W Carolina",1,1,0.5,2
"1583","Charleston So","Wichita St",1,0,0,1
"1584","Charleston So","Winthrop",3,2,0.4,5
"1585","Charleston So","Wofford",1,0,0,1
"1586","Charleston So","Wright St",1,0,0,1
"1587","Charleston So","Columbia Intl",0,2,1,2
"1588","Charleston So","Johnson Bib",0,1,1,1
"1589","Charleston So","St Andrew's",0,1,1,1
"1590","Charleston So","Trinity Bap",0,1,1,1
"1591","Charleston So","Erskine",0,1,1,1
"1592","Charleston So","Johnson TN",0,1,1,1
"1593","Charlotte","Appalachian St",0,2,1,2
"1594","Charlotte","Butler",0,1,1,1
"1595","Charlotte","Charleston So",0,1,1,1
"1596","Charlotte","C Michigan",0,1,1,1
"1597","Charlotte","Col Charleston",1,1,0.5,2
"1598","Charlotte","Davidson",2,1,0.333333333333333,3
"1599","Charlotte","Dayton",1,0,0,1
"1600","Charlotte","Duquesne",0,1,1,1
"1601","Charlotte","East Carolina",1,1,0.5,2
"1602","Charlotte","Elon",0,2,1,2
"1603","Charlotte","ETSU",0,1,1,1
"1604","Charlotte","FL Atlantic",0,2,1,2
"1605","Charlotte","Florida Intl",1,1,0.5,2
"1606","Charlotte","Florida St",2,0,0,2
"1607","Charlotte","Fordham",0,1,1,1
"1608","Charlotte","Ga Southern",0,1,1,1
"1609","Charlotte","Georgetown",1,0,0,1
"1610","Charlotte","Georgia Tech",2,0,0,2
"1611","Charlotte","G Washington",2,0,0,2
"1612","Charlotte","Kansas St",0,1,1,1
"1613","Charlotte","Kennesaw",0,1,1,1
"1614","Charlotte","Lamar",0,1,1,1
"1615","Charlotte","La Salle",0,1,1,1
"1616","Charlotte","Louisiana Tech",3,0,0,3
"1617","Charlotte","Marshall",1,3,0.75,4
"1618","Charlotte","Massachusetts",0,1,1,1
"1619","Charlotte","Miami FL",3,0,0,3
"1620","Charlotte","Michigan",0,1,1,1
"1621","Charlotte","Middle Tenn St",1,0,0,1
"1622","Charlotte","NC A&T",0,2,1,2
"1623","Charlotte","Northeastern",0,2,1,2
"1624","Charlotte","North Texas",1,2,0.666666666666667,3
"1625","Charlotte","Old Dominion",2,1,0.333333333333333,3
"1626","Charlotte","Oral Roberts",0,1,1,1
"1627","Charlotte","Penn St",0,1,1,1
"1628","Charlotte","Radford",0,1,1,1
"1629","Charlotte","Rhode Island",0,1,1,1
"1630","Charlotte","Rice",2,1,0.333333333333333,3
"1631","Charlotte","Richmond",1,0,0,1
"1632","Charlotte","SC Upstate",0,1,1,1
"1633","Charlotte","South Carolina",0,1,1,1
"1634","Charlotte","Southern Miss",1,1,0.5,2
"1635","Charlotte","St Bonaventure",1,0,0,1
"1636","Charlotte","St Joseph's PA",0,1,1,1
"1637","Charlotte","St Louis",1,0,0,1
"1638","Charlotte","Temple",2,0,0,2
"1639","Charlotte","Texas St",0,1,1,1
"1640","Charlotte","Tulane",1,0,0,1
"1641","Charlotte","Tulsa",0,1,1,1
"1642","Charlotte","UAB",2,1,0.333333333333333,3
"1643","Charlotte","UNC Asheville",0,3,1,3
"1644","Charlotte","UTEP",1,1,0.5,2
"1645","Charlotte","UT San Antonio",1,1,0.5,2
"1646","Charlotte","VA Commonwealth",1,0,0,1
"1647","Charlotte","W Kentucky",2,0,0,2
"1648","Charlotte","Xavier",0,1,1,1
"1649","Charlotte","MTSU",2,0,0,2
"1650","Chattanooga","Appalachian St",1,3,0.75,4
"1651","Chattanooga","Butler",1,0,0,1
"1652","Chattanooga","Citadel",0,5,1,5
"1653","Chattanooga","Coastal Car",0,1,1,1
"1654","Chattanooga","Col Charleston",2,0,0,2
"1655","Chattanooga","Davidson",2,0,0,2
"1656","Chattanooga","E Kentucky",2,0,0,2
"1657","Chattanooga","Elon",1,2,0.666666666666667,3
"1658","Chattanooga","ETSU",0,2,1,2
"1659","Chattanooga","Furman",1,5,0.833333333333333,6
"1660","Chattanooga","Ga Southern",3,0,0,3
"1661","Chattanooga","Georgia",2,0,0,2
"1662","Chattanooga","Georgia Tech",1,0,0,1
"1663","Chattanooga","High Point",0,1,1,1
"1664","Chattanooga","IUPUI",0,1,1,1
"1665","Chattanooga","Kansas",1,0,0,1
"1666","Chattanooga","Kennesaw",2,1,0.333333333333333,3
"1667","Chattanooga","Lipscomb",0,1,1,1
"1668","Chattanooga","Louisiana Tech",1,0,0,1
"1669","Chattanooga","LSU",1,0,0,1
"1670","Chattanooga","Maine",0,1,1,1
"1671","Chattanooga","Mercer",2,1,0.333333333333333,3
"1672","Chattanooga","Morehead St",1,0,0,1
"1673","Chattanooga","Nevada",1,0,0,1
"1674","Chattanooga","N Kentucky",1,1,0.5,2
"1675","Chattanooga","Radford",1,0,0,1
"1676","Chattanooga","Robert Morris",0,1,1,1
"1677","Chattanooga","Samford",1,5,0.833333333333333,6
"1678","Chattanooga","SE Missouri St",1,0,0,1
"1679","Chattanooga","Tennessee Tech",1,0,0,1
"1680","Chattanooga","Troy",1,0,0,1
"1681","Chattanooga","UAB",1,1,0.5,2
"1682","Chattanooga","UCLA",1,0,0,1
"1683","Chattanooga","UNC Greensboro",3,3,0.5,6
"1684","Chattanooga","Utah Valley",0,1,1,1
"1685","Chattanooga","VMI",0,2,1,2
"1686","Chattanooga","W Carolina",2,4,0.666666666666667,6
"1687","Chattanooga","Wisconsin",1,0,0,1
"1688","Chattanooga","Wofford",2,3,0.6,5
"1689","Chattanooga","Covenant",0,1,1,1
"1690","Chattanooga","Grand Canyon",0,1,1,1
"1691","Chattanooga","Hiwassee",0,2,1,2
"1692","Chattanooga","Montreat And",0,2,1,2
"1693","Chattanooga","MTSU",1,0,0,1
"1694","Chicago St","Alabama St",1,1,0.5,2
"1695","Chicago St","Arizona St",1,0,0,1
"1696","Chicago St","Bowling Green",1,0,0,1
"1697","Chicago St","Bradley",1,0,0,1
"1698","Chicago St","Cincinnati",1,0,0,1
"1699","Chicago St","Creighton",2,0,0,2
"1700","Chicago St","CS Bakersfield",3,2,0.4,5
"1701","Chicago St","DePaul",3,0,0,3
"1702","Chicago St","Edwardsville",2,1,0.333333333333333,3
"1703","Chicago St","E Illinois",2,0,0,2
"1704","Chicago St","Georgia St",1,0,0,1
"1705","Chicago St","Houston",1,0,0,1
"1706","Chicago St","Houston Bap",0,2,1,2
"1707","Chicago St","Idaho",1,1,0.5,2
"1708","Chicago St","Illinois",1,0,0,1
"1709","Chicago St","Illinois St",1,0,0,1
"1710","Chicago St","Indiana",1,0,0,1
"1711","Chicago St","Jacksonville St",0,1,1,1
"1712","Chicago St","Kent",1,0,0,1
"1713","Chicago St","Loyola-Chicago",1,0,0,1
"1714","Chicago St","Missouri KC",2,2,0.5,4
"1715","Chicago St","NE Omaha",2,1,0.333333333333333,3
"1716","Chicago St","New Mexico St",3,1,0.25,4
"1717","Chicago St","NJIT",2,0,0,2
"1718","Chicago St","Notre Dame",2,0,0,2
"1719","Chicago St","Oakland",1,0,0,1
"1720","Chicago St","Ohio St",1,0,0,1
"1721","Chicago St","Oregon St",1,0,0,1
"1722","Chicago St","Rice",1,0,0,1
"1723","Chicago St","Seattle",3,2,0.4,5
"1724","Chicago St","S Illinois",1,1,0.5,2
"1725","Chicago St","Toledo",1,1,0.5,2
"1726","Chicago St","Tulane",1,0,0,1
"1727","Chicago St","TX Pan American",5,1,0.166666666666667,6
"1728","Chicago St","UNLV",1,0,0,1
"1729","Chicago St","Utah Valley",4,2,0.333333333333333,6
"1730","Chicago St","Valparaiso",1,0,0,1
"1731","Chicago St","W Carolina",1,0,0,1
"1732","Chicago St","WI Green Bay",3,0,0,3
"1733","Chicago St","W Kentucky",1,0,0,1
"1734","Chicago St","Grand Canyon",2,2,0.5,4
"1735","Chicago St","Indiana NW",0,1,1,1
"1736","Chicago St","St Joseph's IN",0,1,1,1
"1737","Chicago St","Urbana",0,1,1,1
"1738","Chicago St","WI Parkside",0,1,1,1
"1739","Chicago St","Trinity Chr",0,1,1,1
"1740","Cincinnati","Alabama",0,1,1,1
"1741","Cincinnati","Appalachian St",0,1,1,1
"1742","Cincinnati","Ark Little Rock",0,1,1,1
"1743","Cincinnati","Campbell",0,2,1,2
"1744","Cincinnati","Chicago St",0,1,1,1
"1745","Cincinnati","Connecticut",5,3,0.375,8
"1746","Cincinnati","DePaul",0,1,1,1
"1747","Cincinnati","East Carolina",1,1,0.5,2
"1748","Cincinnati","E Illinois",0,1,1,1
"1749","Cincinnati","Georgetown",1,0,0,1
"1750","Cincinnati","Houston",0,4,1,4
"1751","Cincinnati","Iowa St",0,1,1,1
"1752","Cincinnati","Kennesaw",0,1,1,1
"1753","Cincinnati","Louisville",2,1,0.333333333333333,3
"1754","Cincinnati","Marquette",0,1,1,1
"1755","Cincinnati","Marshall",0,1,1,1
"1756","Cincinnati","MD E Shore",0,1,1,1
"1757","Cincinnati","Memphis",1,3,0.75,4
"1758","Cincinnati","Middle Tenn St",0,1,1,1
"1759","Cincinnati","Mississippi",1,0,0,1
"1760","Cincinnati","Morehead St",0,1,1,1
"1761","Cincinnati","MS Valley St",0,1,1,1
"1762","Cincinnati","NC A&T",0,1,1,1
"1763","Cincinnati","NC Central",0,2,1,2
"1764","Cincinnati","NC State",0,2,1,2
"1765","Cincinnati","Nebraska",1,1,0.5,2
"1766","Cincinnati","New Mexico",2,0,0,2
"1767","Cincinnati","Notre Dame",2,0,0,2
"1768","Cincinnati","Oregon",0,1,1,1
"1769","Cincinnati","Pittsburgh",1,2,0.666666666666667,3
"1770","Cincinnati","Providence",1,0,0,1
"1771","Cincinnati","Rutgers",0,4,1,4
"1772","Cincinnati","San Diego St",0,1,1,1
"1773","Cincinnati","SC Upstate",0,1,1,1
"1774","Cincinnati","Seton Hall",0,1,1,1
"1775","Cincinnati","SMU",1,3,0.75,4
"1776","Cincinnati","South Florida",0,4,1,4
"1777","Cincinnati","St Francis PA",0,1,1,1
"1778","Cincinnati","St John's",1,0,0,1
"1779","Cincinnati","Stony Brook",0,1,1,1
"1780","Cincinnati","Syracuse",1,0,0,1
"1781","Cincinnati","Temple",1,3,0.75,4
"1782","Cincinnati","TN Martin",0,1,1,1
"1783","Cincinnati","Tulane",1,1,0.5,2
"1784","Cincinnati","Tulsa",0,1,1,1
"1785","Cincinnati","UCF",0,5,1,5
"1786","Cincinnati","VA Commonwealth",1,0,0,1
"1787","Cincinnati","Villanova",0,1,1,1
"1788","Cincinnati","Wagner",0,1,1,1
"1789","Cincinnati","Wright St",0,1,1,1
"1790","Cincinnati","Xavier",2,1,0.333333333333333,3
"1791","Cincinnati","MA Lowell",0,1,1,1
"1792","Cincinnati","MTSU",0,1,1,1
"1793","Citadel","Air Force",2,0,0,2
"1794","Citadel","Appalachian St",2,1,0.333333333333333,3
"1795","Citadel","Army",1,0,0,1
"1796","Citadel","Bethune-Cookman",0,1,1,1
"1797","Citadel","Charleston So",1,0,0,1
"1798","Citadel","Chattanooga",5,0,0,5
"1799","Citadel","Clemson",1,0,0,1
"1800","Citadel","Col Charleston",4,0,0,4
"1801","Citadel","Davidson",4,0,0,4
"1802","Citadel","Elon",2,0,0,2
"1803","Citadel","ETSU",1,1,0.5,2
"1804","Citadel","Florida St",1,0,0,1
"1805","Citadel","Furman",4,3,0.428571428571429,7
"1806","Citadel","Gardner Webb",2,0,0,2
"1807","Citadel","Ga Southern",2,2,0.5,4
"1808","Citadel","Georgia Tech",1,0,0,1
"1809","Citadel","Mercer",2,0,0,2
"1810","Citadel","Michigan St",1,0,0,1
"1811","Citadel","Navy",1,1,0.5,2
"1812","Citadel","Nebraska",1,0,0,1
"1813","Citadel","Presbyterian",1,1,0.5,2
"1814","Citadel","Radford",2,0,0,2
"1815","Citadel","Samford",2,3,0.6,5
"1816","Citadel","St Bonaventure",1,0,0,1
"1817","Citadel","Tennessee",1,0,0,1
"1818","Citadel","Towson",1,0,0,1
"1819","Citadel","UNC Greensboro",3,2,0.4,5
"1820","Citadel","Virginia Tech",1,0,0,1
"1821","Citadel","VMI",4,1,0.2,5
"1822","Citadel","Wake Forest",1,0,0,1
"1823","Citadel","W Carolina",5,0,0,5
"1824","Citadel","Wofford",5,2,0.285714285714286,7
"1825","Citadel","Brevard",0,1,1,1
"1826","Citadel","Montreat And",0,1,1,1
"1827","Citadel","North Greenville",0,1,1,1
"1828","Citadel","Toccoa Falls",0,1,1,1
"1829","Citadel","Warren Wilson",0,1,1,1
"1830","Citadel","West Alabama",1,0,0,1
"1831","Citadel","Bob Jones",0,1,1,1
"1832","Clemson","Arizona",1,0,0,1
"1833","Clemson","Arkansas",1,1,0.5,2
"1834","Clemson","Auburn",1,1,0.5,2
"1835","Clemson","Boston College",2,2,0.5,4
"1836","Clemson","Citadel",0,1,1,1
"1837","Clemson","Coastal Car",1,1,0.5,2
"1838","Clemson","Davidson",0,1,1,1
"1839","Clemson","Delaware St",0,1,1,1
"1840","Clemson","Duke",3,1,0.25,4
"1841","Clemson","Florida A&M",0,2,1,2
"1842","Clemson","Florida St",5,2,0.285714285714286,7
"1843","Clemson","Furman",0,2,1,2
"1844","Clemson","Gardner Webb",1,0,0,1
"1845","Clemson","Georgia Tech",1,6,0.857142857142857,7
"1846","Clemson","Gonzaga",1,0,0,1
"1847","Clemson","High Point",0,1,1,1
"1848","Clemson","Louisville",1,0,0,1
"1849","Clemson","LSU",0,1,1,1
"1850","Clemson","Marist",0,1,1,1
"1851","Clemson","Maryland",1,1,0.5,2
"1852","Clemson","Massachusetts",1,0,0,1
"1853","Clemson","Miami FL",3,1,0.25,4
"1854","Clemson","NC State",3,2,0.4,5
"1855","Clemson","Nevada",0,1,1,1
"1856","Clemson","North Carolina",3,0,0,3
"1857","Clemson","Notre Dame",3,0,0,3
"1858","Clemson","Oakland",0,1,1,1
"1859","Clemson","Pittsburgh",2,1,0.333333333333333,3
"1860","Clemson","Presbyterian",0,1,1,1
"1861","Clemson","Purdue",1,0,0,1
"1862","Clemson","Robert Morris",0,1,1,1
"1863","Clemson","Rutgers",1,0,0,1
"1864","Clemson","S Carolina St",0,2,1,2
"1865","Clemson","South Carolina",1,2,0.666666666666667,3
"1866","Clemson","Stetson",0,1,1,1
"1867","Clemson","Syracuse",1,1,0.5,2
"1868","Clemson","Temple",0,1,1,1
"1869","Clemson","UTEP",0,1,1,1
"1870","Clemson","Virginia",3,1,0.25,4
"1871","Clemson","Virginia Tech",1,3,0.75,4
"1872","Clemson","VMI",0,1,1,1
"1873","Clemson","Wake Forest",1,3,0.75,4
"1874","Clemson","Winthrop",1,0,0,1
"1875","Cleveland St","Akron",2,0,0,2
"1876","Cleveland St","Ball St",0,2,1,2
"1877","Cleveland St","Bowling Green",1,1,0.5,2
"1878","Cleveland St","Detroit",2,5,0.714285714285714,7
"1879","Cleveland St","Drexel",1,0,0,1
"1880","Cleveland St","E Illinois",1,1,0.5,2
"1881","Cleveland St","E Michigan",1,0,0,1
"1882","Cleveland St","Grambling",0,1,1,1
"1883","Cleveland St","IL Chicago",1,6,0.857142857142857,7
"1884","Cleveland St","Iona",1,1,0.5,2
"1885","Cleveland St","Jacksonville St",0,1,1,1
"1886","Cleveland St","Kent",1,1,0.5,2
"1887","Cleveland St","Kentucky",1,0,0,1
"1888","Cleveland St","Louisville",1,0,0,1
"1889","Cleveland St","Loyola-Chicago",2,0,0,2
"1890","Cleveland St","Marshall",0,1,1,1
"1891","Cleveland St","Michigan",1,0,0,1
"1892","Cleveland St","NC State",1,0,0,1
"1893","Cleveland St","Oakland",1,3,0.75,4
"1894","Cleveland St","Old Dominion",0,1,1,1
"1895","Cleveland St","Robert Morris",1,1,0.5,2
"1896","Cleveland St","San Francisco",1,1,0.5,2
"1897","Cleveland St","Savannah St",1,0,0,1
"1898","Cleveland St","St Bonaventure",1,0,0,1
"1899","Cleveland St","Toledo",2,1,0.333333333333333,3
"1900","Cleveland St","UT Arlington",0,1,1,1
"1901","Cleveland St","VA Commonwealth",1,0,0,1
"1902","Cleveland St","Valparaiso",5,2,0.285714285714286,7
"1903","Cleveland St","Virginia",1,0,0,1
"1904","Cleveland St","W Carolina",0,1,1,1
"1905","Cleveland St","WI Green Bay",4,2,0.333333333333333,6
"1906","Cleveland St","W Illinois",0,2,1,2
"1907","Cleveland St","WI Milwaukee",2,4,0.666666666666667,6
"1908","Cleveland St","Wright St",4,3,0.428571428571429,7
"1909","Cleveland St","Youngstown St",2,4,0.666666666666667,6
"1910","Cleveland St","La Roche",0,1,1,1
"1911","Cleveland St","Notre Dame OH",0,1,1,1
"1912","Cleveland St","Mt Vernon Naz",0,1,1,1
"1913","Cleveland St","Tiffin",0,1,1,1
"1914","C Michigan","Akron",3,0,0,3
"1915","C Michigan","Ark Pine Bluff",0,2,1,2
"1916","C Michigan","Austin Peay",0,1,1,1
"1917","C Michigan","Ball St",3,3,0.5,6
"1918","C Michigan","Bowling Green",2,1,0.333333333333333,3
"1919","C Michigan","Bradley",3,0,0,3
"1920","C Michigan","Buffalo",3,2,0.4,5
"1921","C Michigan","Charlotte",1,0,0,1
"1922","C Michigan","CS Northridge",0,1,1,1
"1923","C Michigan","Dayton",1,0,0,1
"1924","C Michigan","Edwardsville",0,2,1,2
"1925","C Michigan","E Michigan",4,3,0.428571428571429,7
"1926","C Michigan","Idaho St",0,1,1,1
"1927","C Michigan","Iowa",1,0,0,1
"1928","C Michigan","Jacksonville St",1,1,0.5,2
"1929","C Michigan","Kent",3,1,0.25,4
"1930","C Michigan","Maine",0,1,1,1
"1931","C Michigan","McNeese St",0,1,1,1
"1932","C Michigan","Miami OH",3,1,0.25,4
"1933","C Michigan","Michigan",1,0,0,1
"1934","C Michigan","Montana St",1,0,0,1
"1935","C Michigan","Nebraska",1,0,0,1
"1936","C Michigan","Niagara",0,1,1,1
"1937","C Michigan","N Illinois",3,3,0.5,6
"1938","C Michigan","Northwestern",0,1,1,1
"1939","C Michigan","Ohio",2,2,0.5,4
"1940","C Michigan","Pepperdine",1,1,0.5,2
"1941","C Michigan","TAM C. Christi",0,1,1,1
"1942","C Michigan","Texas St",0,1,1,1
"1943","C Michigan","Toledo",4,3,0.428571428571429,7
"1944","C Michigan","Utah",1,0,0,1
"1945","C Michigan","W Michigan",5,1,0.166666666666667,6
"1946","C Michigan","Wright St",0,1,1,1
"1947","C Michigan","Youngstown St",1,1,0.5,2
"1948","C Michigan","Central Penn",0,1,1,1
"1949","C Michigan","Concordia MI",0,1,1,1
"1950","C Michigan","Grand Canyon",0,1,1,1
"1951","C Michigan","Manchester",0,1,1,1
"1952","C Michigan","Marygrove",0,1,1,1
"1953","C Michigan","Alma",0,1,1,1
"1954","Coastal Car","Akron",1,1,0.5,2
"1955","Coastal Car","Auburn",0,1,1,1
"1956","Coastal Car","Boston Univ",2,0,0,2
"1957","Coastal Car","Campbell",0,4,1,4
"1958","Coastal Car","Cent Arkansas",0,1,1,1
"1959","Coastal Car","Central Conn",0,2,1,2
"1960","Coastal Car","Charleston So",3,4,0.571428571428571,7
"1961","Coastal Car","Chattanooga",1,0,0,1
"1962","Coastal Car","Clemson",1,1,0.5,2
"1963","Coastal Car","Col Charleston",1,0,0,1
"1964","Coastal Car","Florida Intl",1,0,0,1
"1965","Coastal Car","Gardner Webb",4,3,0.428571428571429,7
"1966","Coastal Car","High Point",2,2,0.5,4
"1967","Coastal Car","Liberty",2,3,0.6,5
"1968","Coastal Car","Longwood",0,4,1,4
"1969","Coastal Car","Minnesota",1,0,0,1
"1970","Coastal Car","Mississippi",3,0,0,3
"1971","Coastal Car","Presbyterian",1,5,0.833333333333333,6
"1972","Coastal Car","Radford",0,3,1,3
"1973","Coastal Car","S Carolina St",2,2,0.5,4
"1974","Coastal Car","St Francis NY",0,1,1,1
"1975","Coastal Car","Tennessee Tech",1,0,0,1
"1976","Coastal Car","UCLA",1,0,0,1
"1977","Coastal Car","ULL",1,0,0,1
"1978","Coastal Car","ULM",0,1,1,1
"1979","Coastal Car","UNC Asheville",3,4,0.571428571428571,7
"1980","Coastal Car","VMI",0,3,1,3
"1981","Coastal Car","W Carolina",1,1,0.5,2
"1982","Coastal Car","Winthrop",4,3,0.428571428571429,7
"1983","Coastal Car","Columbia Intl",0,1,1,1
"1984","Coastal Car","Guilford",0,1,1,1
"1985","Coastal Car","NC Wesleyan",0,1,1,1
"1986","Coastal Car","Reinhardt",0,1,1,1
"1987","Coastal Car","Trinity Bap",0,1,1,1
"1988","Coastal Car","Warren Wilson",0,1,1,1
"1989","Coastal Car","Piedmont Bap",0,1,1,1
"1990","Col Charleston","Appalachian St",0,1,1,1
"1991","Col Charleston","Arizona St",1,0,0,1
"1992","Col Charleston","Auburn",1,0,0,1
"1993","Col Charleston","Baylor",0,1,1,1
"1994","Col Charleston","Boston College",0,1,1,1
"1995","Col Charleston","Campbell",0,1,1,1
"1996","Col Charleston","Charleston So",0,1,1,1
"1997","Col Charleston","Charlotte",1,1,0.5,2
"1998","Col Charleston","Chattanooga",0,2,1,2
"1999","Col Charleston","Citadel",0,4,1,4
"2000","Col Charleston","Coastal Car",0,1,1,1
"2001","Col Charleston","Connecticut",1,0,0,1
"2002","Col Charleston","CS Fullerton",0,1,1,1
"2003","Col Charleston","Davidson",3,1,0.25,4
"2004","Col Charleston","Delaware",4,0,0,4
"2005","Col Charleston","Drexel",3,2,0.4,5
"2006","Col Charleston","Elon",0,3,1,3
"2007","Col Charleston","Furman",0,4,1,4
"2008","Col Charleston","Gardner Webb",2,0,0,2
"2009","Col Charleston","Ga Southern",1,1,0.5,2
"2010","Col Charleston","George Mason",0,1,1,1
"2011","Col Charleston","Hofstra",3,1,0.25,4
"2012","Col Charleston","Howard",0,1,1,1
"2013","Col Charleston","James Madison",3,1,0.25,4
"2014","Col Charleston","Kent",1,0,0,1
"2015","Col Charleston","Louisville",2,0,0,2
"2016","Col Charleston","LSU",1,0,0,1
"2017","Col Charleston","Marist",1,1,0.5,2
"2018","Col Charleston","Miami FL",2,0,0,2
"2019","Col Charleston","Northeastern",3,1,0.25,4
"2020","Col Charleston","Old Dominion",0,2,1,2
"2021","Col Charleston","Samford",1,1,0.5,2
"2022","Col Charleston","San Diego St",1,0,0,1
"2023","Col Charleston","S Carolina St",0,1,1,1
"2024","Col Charleston","St John's",1,0,0,1
"2025","Col Charleston","Texas A&M",1,0,0,1
"2026","Col Charleston","Towson",4,1,0.2,5
"2027","Col Charleston","UNC Asheville",1,0,0,1
"2028","Col Charleston","UNC Greensboro",0,1,1,1
"2029","Col Charleston","UNC Wilmington",4,1,0.2,5
"2030","Col Charleston","Vermont",0,1,1,1
"2031","Col Charleston","W Carolina",0,1,1,1
"2032","Col Charleston","West Virginia",1,0,0,1
"2033","Col Charleston","William & Mary",3,2,0.4,5
"2034","Col Charleston","Wofford",0,2,1,2
"2035","Col Charleston","Coker",0,1,1,1
"2036","Colgate","Albany NY",2,1,0.333333333333333,3
"2037","Colgate","American Univ",6,2,0.25,8
"2038","Colgate","Arizona St",1,0,0,1
"2039","Colgate","Army",4,2,0.333333333333333,6
"2040","Colgate","Binghamton",0,3,1,3
"2041","Colgate","Boston Univ",2,2,0.5,4
"2042","Colgate","Bucknell",4,2,0.333333333333333,6
"2043","Colgate","Campbell",0,1,1,1
"2044","Colgate","Columbia",3,0,0,3
"2045","Colgate","Coppin St",0,1,1,1
"2046","Colgate","Cornell",2,1,0.333333333333333,3
"2047","Colgate","Dartmouth",0,1,1,1
"2048","Colgate","Elon",1,0,0,1
"2049","Colgate","Fordham",1,0,0,1
"2050","Colgate","Georgetown",1,0,0,1
"2051","Colgate","Holy Cross",4,2,0.333333333333333,6
"2052","Colgate","Illinois",1,0,0,1
"2053","Colgate","James Madison",1,0,0,1
"2054","Colgate","Lafayette",3,3,0.5,6
"2055","Colgate","La Salle",1,0,0,1
"2056","Colgate","Lehigh",3,4,0.571428571428571,7
"2057","Colgate","Loyola MD",2,2,0.5,4
"2058","Colgate","Marist",0,1,1,1
"2059","Colgate","Marquette",1,0,0,1
"2060","Colgate","Navy",2,6,0.75,8
"2061","Colgate","New Hampshire",1,1,0.5,2
"2062","Colgate","NJIT",1,0,0,1
"2063","Colgate","Ohio St",1,0,0,1
"2064","Colgate","Providence",1,0,0,1
"2065","Colgate","Quinnipiac",1,0,0,1
"2066","Colgate","Sacred Heart",1,0,0,1
"2067","Colgate","St Francis NY",1,0,0,1
"2068","Colgate","St Francis PA",0,2,1,2
"2069","Colgate","Syracuse",3,0,0,3
"2070","Colgate","Tulane",0,1,1,1
"2071","Colgate","Wake Forest",1,0,0,1
"2072","Colgate","Ursinus",0,1,1,1
"2073","Colgate","Morrisville St",0,1,1,1
"2074","Colorado","Air Force",0,3,1,3
"2075","Colorado","Arizona",6,1,0.142857142857143,7
"2076","Colorado","Arizona St",4,2,0.333333333333333,6
"2077","Colorado","Arkansas St",0,1,1,1
"2078","Colorado","Auburn",0,1,1,1
"2079","Colorado","Baylor",1,1,0.5,2
"2080","Colorado","California",3,2,0.4,5
"2081","Colorado","Colorado St",1,2,0.666666666666667,3
"2082","Colorado","Dayton",0,1,1,1
"2083","Colorado","DePaul",0,1,1,1
"2084","Colorado","Drexel",0,1,1,1
"2085","Colorado","Elon",0,1,1,1
"2086","Colorado","Fresno St",0,1,1,1
"2087","Colorado","Georgia",1,1,0.5,2
"2088","Colorado","G Washington",1,0,0,1
"2089","Colorado","Hartford",0,1,1,1
"2090","Colorado","Harvard",0,1,1,1
"2091","Colorado","Hawaii",1,0,0,1
"2092","Colorado","Jackson St",0,1,1,1
"2093","Colorado","Kansas",1,1,0.5,2
"2094","Colorado","Lipscomb",0,1,1,1
"2095","Colorado","Murray St",0,1,1,1
"2096","Colorado","N Colorado",0,1,1,1
"2097","Colorado","Northern Arizona",0,1,1,1
"2098","Colorado","Oklahoma St",1,0,0,1
"2099","Colorado","Oregon",2,3,0.6,5
"2100","Colorado","Oregon St",2,3,0.6,5
"2101","Colorado","San Francisco",0,1,1,1
"2102","Colorado","Santa Barbara",0,1,1,1
"2103","Colorado","Stanford",0,4,1,4
"2104","Colorado","TN Martin",0,1,1,1
"2105","Colorado","TX Southern",0,1,1,1
"2106","Colorado","UCLA",4,1,0.2,5
"2107","Colorado","USC",0,6,1,6
"2108","Colorado","Utah",4,2,0.333333333333333,6
"2109","Colorado","Washington",3,2,0.4,5
"2110","Colorado","Washington St",1,4,0.8,5
"2111","Colorado","Wofford",0,1,1,1
"2112","Colorado","Wyoming",2,1,0.333333333333333,3
"2113","Colorado St","Air Force",0,6,1,6
"2114","Colorado St","Bethune-Cookman",0,1,1,1
"2115","Colorado St","Boise St",3,2,0.4,5
"2116","Colorado St","Charleston So",0,1,1,1
"2117","Colorado St","Colorado",2,1,0.333333333333333,3
"2118","Colorado St","CS Bakersfield",0,1,1,1
"2119","Colorado St","Denver",1,2,0.666666666666667,3
"2120","Colorado St","Evansville",0,1,1,1
"2121","Colorado St","Fresno St",1,6,0.857142857142857,7
"2122","Colorado St","Georgia St",0,1,1,1
"2123","Colorado St","Gonzaga",1,0,0,1
"2124","Colorado St","IL Chicago",1,1,0.5,2
"2125","Colorado St","Lamar",0,1,1,1
"2126","Colorado St","Mercer",0,1,1,1
"2127","Colorado St","Missouri St",0,1,1,1
"2128","Colorado St","Montana",0,2,1,2
"2129","Colorado St","N Colorado",0,3,1,3
"2130","Colorado St","Nevada",1,4,0.8,5
"2131","Colorado St","New Mexico",5,1,0.166666666666667,6
"2132","Colorado St","New Mexico St",0,2,1,2
"2133","Colorado St","North Florida",0,1,1,1
"2134","Colorado St","Pacific",0,1,1,1
"2135","Colorado St","Portland",0,1,1,1
"2136","Colorado St","Prairie View",0,1,1,1
"2137","Colorado St","San Diego St",5,2,0.285714285714286,7
"2138","Colorado St","San Jose St",0,4,1,4
"2139","Colorado St","Santa Barbara",0,1,1,1
"2140","Colorado St","St Bonaventure",0,1,1,1
"2141","Colorado St","UNLV",2,3,0.6,5
"2142","Colorado St","Utah St",3,1,0.25,4
"2143","Colorado St","UTEP",1,2,0.666666666666667,3
"2144","Colorado St","Virginia Tech",0,1,1,1
"2145","Colorado St","Washington",0,1,1,1
"2146","Colorado St","Weber St",0,1,1,1
"2147","Colorado St","Wyoming",3,3,0.5,6
"2148","Colorado St","Arkansas-FS",0,1,1,1
"2149","Colorado St","Col Springs",0,1,1,1
"2150","Colorado St","SW Oklahoma",0,1,1,1
"2151","Columbia","American Univ",0,3,1,3
"2152","Columbia","Army",0,2,1,2
"2153","Columbia","Brown",3,3,0.5,6
"2154","Columbia","Bucknell",2,1,0.333333333333333,3
"2155","Columbia","Colgate",0,3,1,3
"2156","Columbia","Connecticut",1,0,0,1
"2157","Columbia","Cornell",2,4,0.666666666666667,6
"2158","Columbia","Dartmouth",4,2,0.333333333333333,6
"2159","Columbia","Elon",2,0,0,2
"2160","Columbia","F Dickinson",0,2,1,2
"2161","Columbia","Furman",0,1,1,1
"2162","Columbia","Harvard",5,1,0.166666666666667,6
"2163","Columbia","Hofstra",0,1,1,1
"2164","Columbia","Holy Cross",1,0,0,1
"2165","Columbia","Idaho",0,1,1,1
"2166","Columbia","Kentucky",1,0,0,1
"2167","Columbia","Lehigh",0,1,1,1
"2168","Columbia","Long Island",1,0,0,1
"2169","Columbia","Loyola MD",1,0,0,1
"2170","Columbia","Manhattan",1,1,0.5,2
"2171","Columbia","Marist",1,0,0,1
"2172","Columbia","MD E Shore",0,1,1,1
"2173","Columbia","Michigan St",1,0,0,1
"2174","Columbia","North Texas",0,1,1,1
"2175","Columbia","Penn",3,3,0.5,6
"2176","Columbia","Portland",1,0,0,1
"2177","Columbia","Princeton",5,1,0.166666666666667,6
"2178","Columbia","San Francisco",1,0,0,1
"2179","Columbia","St Francis NY",1,1,0.5,2
"2180","Columbia","St John's",1,0,0,1
"2181","Columbia","Stony Brook",2,1,0.333333333333333,3
"2182","Columbia","Villanova",0,1,1,1
"2183","Columbia","Wagner",0,1,1,1
"2184","Columbia","Yale",3,3,0.5,6
"2185","Columbia","Central Penn",0,2,1,2
"2186","Columbia","MA Lowell",0,1,1,1
"2187","Connecticut","Boston College",0,1,1,1
"2188","Connecticut","Boston Univ",0,1,1,1
"2189","Connecticut","Bryant",0,1,1,1
"2190","Connecticut","Central Conn",0,1,1,1
"2191","Connecticut","Cincinnati",3,5,0.625,8
"2192","Connecticut","Col Charleston",0,1,1,1
"2193","Connecticut","Columbia",0,1,1,1
"2194","Connecticut","Coppin St",0,1,1,1
"2195","Connecticut","Dayton",0,1,1,1
"2196","Connecticut","DePaul",0,2,1,2
"2197","Connecticut","Detroit",0,1,1,1
"2198","Connecticut","Duke",1,0,0,1
"2199","Connecticut","East Carolina",0,2,1,2
"2200","Connecticut","E Washington",0,1,1,1
"2201","Connecticut","Florida",0,2,1,2
"2202","Connecticut","Fordham",0,1,1,1
"2203","Connecticut","Georgetown",1,0,0,1
"2204","Connecticut","Harvard",0,2,1,2
"2205","Connecticut","Houston",2,1,0.333333333333333,3
"2206","Connecticut","Indiana",0,1,1,1
"2207","Connecticut","Louisville",4,0,0,4
"2208","Connecticut","Loyola MD",0,1,1,1
"2209","Connecticut","Maine",0,1,1,1
"2210","Connecticut","Marquette",1,0,0,1
"2211","Connecticut","Maryland",0,1,1,1
"2212","Connecticut","MD E Shore",0,1,1,1
"2213","Connecticut","Memphis",2,3,0.6,5
"2214","Connecticut","Michigan St",0,1,1,1
"2215","Connecticut","NC State",1,0,0,1
"2216","Connecticut","New Hampshire",0,1,1,1
"2217","Connecticut","New Mexico",1,0,0,1
"2218","Connecticut","Notre Dame",0,1,1,1
"2219","Connecticut","Pittsburgh",1,0,0,1
"2220","Connecticut","Providence",0,2,1,2
"2221","Connecticut","Quinnipiac",0,1,1,1
"2222","Connecticut","Rutgers",0,3,1,3
"2223","Connecticut","Seton Hall",0,1,1,1
"2224","Connecticut","SMU",4,1,0.2,5
"2225","Connecticut","South Florida",1,6,0.857142857142857,7
"2226","Connecticut","Stanford",2,0,0,2
"2227","Connecticut","St John's",1,0,0,1
"2228","Connecticut","Stony Brook",0,1,1,1
"2229","Connecticut","Syracuse",0,1,1,1
"2230","Connecticut","Temple",2,2,0.5,4
"2231","Connecticut","Texas",1,0,0,1
"2232","Connecticut","Tulane",0,2,1,2
"2233","Connecticut","Tulsa",1,2,0.666666666666667,3
"2234","Connecticut","UCF",0,3,1,3
"2235","Connecticut","Vermont",0,1,1,1
"2236","Connecticut","Villanova",1,0,0,1
"2237","Connecticut","Wake Forest",0,1,1,1
"2238","Connecticut","Washington",0,2,1,2
"2239","Connecticut","West Virginia",1,0,0,1
"2240","Connecticut","Yale",1,1,0.5,2
"2241","Coppin St","Akron",3,0,0,3
"2242","Coppin St","Arizona St",1,0,0,1
"2243","Coppin St","Bethune-Cookman",1,3,0.75,4
"2244","Coppin St","California",1,0,0,1
"2245","Coppin St","Colgate",1,0,0,1
"2246","Coppin St","Connecticut",1,0,0,1
"2247","Coppin St","Delaware St",2,3,0.6,5
"2248","Coppin St","Denver",1,0,0,1
"2249","Coppin St","E Kentucky",1,0,0,1
"2250","Coppin St","E Michigan",1,0,0,1
"2251","Coppin St","Evansville",1,0,0,1
"2252","Coppin St","FL Atlantic",1,0,0,1
"2253","Coppin St","Florida A&M",1,1,0.5,2
"2254","Coppin St","Gonzaga",1,0,0,1
"2255","Coppin St","Hampton",3,3,0.5,6
"2256","Coppin St","Hofstra",1,0,0,1
"2257","Coppin St","Howard",3,2,0.4,5
"2258","Coppin St","Illinois",1,0,0,1
"2259","Coppin St","Indiana",1,0,0,1
"2260","Coppin St","Iowa",1,0,0,1
"2261","Coppin St","Jacksonville St",1,0,0,1
"2262","Coppin St","Loyola MD",1,0,0,1
"2263","Coppin St","Marshall",1,0,0,1
"2264","Coppin St","MD Baltimore Co",0,1,1,1
"2265","Coppin St","MD E Shore",3,2,0.4,5
"2266","Coppin St","Michigan",2,0,0,2
"2267","Coppin St","Morgan St",5,2,0.285714285714286,7
"2268","Coppin St","NC A&T",1,2,0.666666666666667,3
"2269","Coppin St","NC Central",4,0,0,4
"2270","Coppin St","Norfolk St",6,0,0,6
"2271","Coppin St","Notre Dame",1,0,0,1
"2272","Coppin St","Oregon",1,0,0,1
"2273","Coppin St","Oregon St",0,1,1,1
"2274","Coppin St","Richmond",1,0,0,1
"2275","Coppin St","Savannah St",3,0,0,3
"2276","Coppin St","S Carolina St",0,3,1,3
"2277","Coppin St","Southern Miss",1,0,0,1
"2278","Coppin St","St Joseph's PA",1,0,0,1
"2279","Coppin St","Texas",1,0,0,1
"2280","Coppin St","Toledo",1,0,0,1
"2281","Coppin St","Towson",2,1,0.333333333333333,3
"2282","Coppin St","USC",1,0,0,1
"2283","Coppin St","Wagner",2,0,0,2
"2284","Coppin St","Ohio Valley",0,1,1,1
"2285","Coppin St","UMBC",0,1,1,1
"2286","Coppin St","Goldey Beacom",0,1,1,1
"2287","Cornell","American Univ",0,1,1,1
"2288","Cornell","Arizona St",1,0,0,1
"2289","Cornell","Binghamton",1,2,0.666666666666667,3
"2290","Cornell","Boston Univ",1,0,0,1
"2291","Cornell","Brown",4,2,0.333333333333333,6
"2292","Cornell","Bucknell",1,0,0,1
"2293","Cornell","Buffalo",1,0,0,1
"2294","Cornell","Canisius",0,1,1,1
"2295","Cornell","Colgate",1,2,0.666666666666667,3
"2296","Cornell","Columbia",4,2,0.333333333333333,6
"2297","Cornell","Dartmouth",3,3,0.5,6
"2298","Cornell","Drexel",1,0,0,1
"2299","Cornell","Duke",1,0,0,1
"2300","Cornell","George Mason",0,1,1,1
"2301","Cornell","Harvard",5,1,0.166666666666667,6
"2302","Cornell","Howard",0,1,1,1
"2303","Cornell","Longwood",0,1,1,1
"2304","Cornell","Louisville",1,0,0,1
"2305","Cornell","Loyola MD",2,0,0,2
"2306","Cornell","Notre Dame",1,0,0,1
"2307","Cornell","Penn",5,1,0.166666666666667,6
"2308","Cornell","Penn St",1,0,0,1
"2309","Cornell","Presbyterian",0,1,1,1
"2310","Cornell","Princeton",5,1,0.166666666666667,6
"2311","Cornell","Radford",2,0,0,2
"2312","Cornell","Siena",1,1,0.5,2
"2313","Cornell","South Carolina",1,0,0,1
"2314","Cornell","St Bonaventure",2,0,0,2
"2315","Cornell","St Francis PA",1,1,0.5,2
"2316","Cornell","Stony Brook",2,0,0,2
"2317","Cornell","St Peter's",3,0,0,3
"2318","Cornell","Syracuse",2,0,0,2
"2319","Cornell","Vanderbilt",1,0,0,1
"2320","Cornell","Wisconsin",1,0,0,1
"2321","Cornell","W Michigan",1,1,0.5,2
"2322","Cornell","Yale",5,1,0.166666666666667,6
"2323","Cornell","MA Lowell",0,1,1,1
"2324","Cornell","Oberlin",0,1,1,1
"2325","Cornell","Alfred St",0,1,1,1
"2326","Creighton","Akron",0,1,1,1
"2327","Creighton","Alcorn St",0,1,1,1
"2328","Creighton","Arizona St",0,2,1,2
"2329","Creighton","Ark Pine Bluff",0,1,1,1
"2330","Creighton","Boise St",1,0,0,1
"2331","Creighton","Bradley",0,2,1,2
"2332","Creighton","Butler",2,2,0.5,4
"2333","Creighton","California",0,2,1,2
"2334","Creighton","Cent Arkansas",0,1,1,1
"2335","Creighton","Chicago St",0,2,1,2
"2336","Creighton","DePaul",1,5,0.833333333333333,6
"2337","Creighton","Drake",1,1,0.5,2
"2338","Creighton","E Illinois",0,1,1,1
"2339","Creighton","Evansville",0,2,1,2
"2340","Creighton","Georgetown",4,1,0.2,5
"2341","Creighton","G Washington",1,0,0,1
"2342","Creighton","Illinois St",1,1,0.5,2
"2343","Creighton","Indiana St",1,1,0.5,2
"2344","Creighton","Long Beach St",0,1,1,1
"2345","Creighton","Longwood",0,1,1,1
"2346","Creighton","Marquette",1,3,0.75,4
"2347","Creighton","Mississippi",1,0,0,1
"2348","Creighton","Missouri KC",0,1,1,1
"2349","Creighton","Missouri St",0,2,1,2
"2350","Creighton","NC Central",0,1,1,1
"2351","Creighton","Nebraska",0,3,1,3
"2352","Creighton","Northern Iowa",1,1,0.5,2
"2353","Creighton","North Texas",1,1,0.5,2
"2354","Creighton","Oklahoma",0,1,1,1
"2355","Creighton","Presbyterian",0,1,1,1
"2356","Creighton","Providence",4,1,0.2,5
"2357","Creighton","San Diego St",1,0,0,1
"2358","Creighton","Seton Hall",2,2,0.5,4
"2359","Creighton","S Illinois",0,2,1,2
"2360","Creighton","South Dakota",0,1,1,1
"2361","Creighton","St John's",2,2,0.5,4
"2362","Creighton","St Joseph's PA",0,2,1,2
"2363","Creighton","St Mary's CA",2,0,0,2
"2364","Creighton","Tulsa",1,2,0.666666666666667,3
"2365","Creighton","TX Pan American",0,1,1,1
"2366","Creighton","UAB",0,1,1,1
"2367","Creighton","Villanova",2,2,0.5,4
"2368","Creighton","Wichita St",1,1,0.5,2
"2369","Creighton","Wisconsin",0,1,1,1
"2370","Creighton","Xavier",2,3,0.6,5
"2371","Creighton","MTSU",0,1,1,1
"2372","CS Bakersfield","Ark Pine Bluff",1,0,0,1
"2373","CS Bakersfield","California",1,1,0.5,2
"2374","CS Bakersfield","Chicago St",2,3,0.6,5
"2375","CS Bakersfield","Colorado St",1,0,0,1
"2376","CS Bakersfield","CS Fullerton",1,1,0.5,2
"2377","CS Bakersfield","CS Sacramento",1,1,0.5,2
"2378","CS Bakersfield","Delaware",0,1,1,1
"2379","CS Bakersfield","Drake",1,0,0,1
"2380","CS Bakersfield","Fresno St",2,0,0,2
"2381","CS Bakersfield","Hawaii",1,0,0,1
"2382","CS Bakersfield","High Point",1,0,0,1
"2383","CS Bakersfield","Idaho",1,1,0.5,2
"2384","CS Bakersfield","Idaho St",0,3,1,3
"2385","CS Bakersfield","Loy Marymount",2,0,0,2
"2386","CS Bakersfield","Missouri KC",2,2,0.5,4
"2387","CS Bakersfield","MS Valley St",0,1,1,1
"2388","CS Bakersfield","NC A&T",1,1,0.5,2
"2389","CS Bakersfield","NE Omaha",1,1,0.5,2
"2390","CS Bakersfield","Nevada",0,1,1,1
"2391","CS Bakersfield","New Mexico St",6,0,0,6
"2392","CS Bakersfield","Northern Arizona",0,1,1,1
"2393","CS Bakersfield","North Florida",1,0,0,1
"2394","CS Bakersfield","Portland",1,0,0,1
"2395","CS Bakersfield","Portland St",1,0,0,1
"2396","CS Bakersfield","San Diego St",2,0,0,2
"2397","CS Bakersfield","Santa Clara",2,0,0,2
"2398","CS Bakersfield","S Dakota St",2,1,0.333333333333333,3
"2399","CS Bakersfield","Seattle",1,4,0.8,5
"2400","CS Bakersfield","South Dakota",1,0,0,1
"2401","CS Bakersfield","TX Pan American",2,3,0.6,5
"2402","CS Bakersfield","UC Riverside",1,0,0,1
"2403","CS Bakersfield","UNLV",1,0,0,1
"2404","CS Bakersfield","USC",1,0,0,1
"2405","CS Bakersfield","Utah St",1,0,0,1
"2406","CS Bakersfield","Utah Valley",3,4,0.571428571428571,7
"2407","CS Bakersfield","UT Arlington",2,0,0,2
"2408","CS Bakersfield","UT San Antonio",0,3,1,3
"2409","CS Bakersfield","Washington St",1,0,0,1
"2410","CS Bakersfield","Wyoming",2,0,0,2
"2411","CS Bakersfield","Grand Canyon",4,0,0,4
"2412","CS Bakersfield","La Verne",0,1,1,1
"2413","CS Bakersfield","San Diego Chr",0,1,1,1
"2414","CS Bakersfield","UC Merced",0,1,1,1
"2415","CS Bakersfield","Bristol",0,1,1,1
"2416","CS Fullerton","Cal Poly SLO",4,2,0.333333333333333,6
"2417","CS Fullerton","Col Charleston",1,0,0,1
"2418","CS Fullerton","CS Bakersfield",1,1,0.5,2
"2419","CS Fullerton","CS Northridge",3,3,0.5,6
"2420","CS Fullerton","CS Sacramento",1,1,0.5,2
"2421","CS Fullerton","E Washington",1,0,0,1
"2422","CS Fullerton","Florida Intl",0,1,1,1
"2423","CS Fullerton","Hawaii",6,0,0,6
"2424","CS Fullerton","Idaho St",0,1,1,1
"2425","CS Fullerton","Long Beach St",6,1,0.142857142857143,7
"2426","CS Fullerton","Marquette",1,0,0,1
"2427","CS Fullerton","Miami FL",1,0,0,1
"2428","CS Fullerton","Montana St",0,1,1,1
"2429","CS Fullerton","Nevada",1,1,0.5,2
"2430","CS Fullerton","New Mexico",1,0,0,1
"2431","CS Fullerton","Pacific",2,0,0,2
"2432","CS Fullerton","Pepperdine",1,1,0.5,2
"2433","CS Fullerton","San Jose St",1,1,0.5,2
"2434","CS Fullerton","Santa Barbara",4,2,0.333333333333333,6
"2435","CS Fullerton","Santa Clara",1,1,0.5,2
"2436","CS Fullerton","SC Upstate",1,0,0,1
"2437","CS Fullerton","Seattle",2,1,0.333333333333333,3
"2438","CS Fullerton","Southern Utah",0,1,1,1
"2439","CS Fullerton","Stanford",1,0,0,1
"2440","CS Fullerton","TAM C. Christi",0,2,1,2
"2441","CS Fullerton","Tulsa",1,0,0,1
"2442","CS Fullerton","TX Southern",0,2,1,2
"2443","CS Fullerton","UC Davis",4,2,0.333333333333333,6
"2444","CS Fullerton","UC Irvine",6,0,0,6
"2445","CS Fullerton","UCLA",1,0,0,1
"2446","CS Fullerton","UC Riverside",3,3,0.5,6
"2447","CS Fullerton","UNLV",1,0,0,1
"2448","CS Fullerton","USC",2,0,0,2
"2449","CS Fullerton","Washington",1,0,0,1
"2450","CS Fullerton","WI Green Bay",0,1,1,1
"2451","CS Fullerton","Wright St",0,1,1,1
"2452","CS Fullerton","CS Dom. Hills",0,1,1,1
"2453","CS Fullerton","CSU East Bay",0,1,1,1
"2454","CS Northridge","Arizona",1,0,0,1
"2455","CS Northridge","Arizona St",1,0,0,1
"2456","CS Northridge","Ark Little Rock",1,0,0,1
"2457","CS Northridge","Austin Peay",0,1,1,1
"2458","CS Northridge","BYU",1,0,0,1
"2459","CS Northridge","Cal Poly SLO",6,1,0.142857142857143,7
"2460","CS Northridge","C Michigan",1,0,0,1
"2461","CS Northridge","CS Fullerton",3,3,0.5,6
"2462","CS Northridge","E Washington",0,1,1,1
"2463","CS Northridge","Fresno St",1,0,0,1
"2464","CS Northridge","Hawaii",4,3,0.428571428571429,7
"2465","CS Northridge","Idaho",1,1,0.5,2
"2466","CS Northridge","Long Beach St",5,2,0.285714285714286,7
"2467","CS Northridge","Louisville",1,0,0,1
"2468","CS Northridge","Montana St",1,2,0.666666666666667,3
"2469","CS Northridge","Morgan St",0,2,1,2
"2470","CS Northridge","N Kentucky",0,1,1,1
"2471","CS Northridge","Oregon",1,0,0,1
"2472","CS Northridge","Pacific",2,0,0,2
"2473","CS Northridge","Pepperdine",1,1,0.5,2
"2474","CS Northridge","Portland St",1,0,0,1
"2475","CS Northridge","Samford",0,1,1,1
"2476","CS Northridge","San Diego",0,1,1,1
"2477","CS Northridge","San Diego St",1,0,0,1
"2478","CS Northridge","Santa Barbara",3,3,0.5,6
"2479","CS Northridge","Seattle",2,0,0,2
"2480","CS Northridge","SF Austin",2,0,0,2
"2481","CS Northridge","Siena",0,1,1,1
"2482","CS Northridge","South Dakota",2,0,0,2
"2483","CS Northridge","Southern Utah",1,1,0.5,2
"2484","CS Northridge","TAM C. Christi",1,1,0.5,2
"2485","CS Northridge","Tulsa",0,1,1,1
"2486","CS Northridge","UC Davis",6,1,0.142857142857143,7
"2487","CS Northridge","UC Irvine",4,2,0.333333333333333,6
"2488","CS Northridge","UCLA",1,0,0,1
"2489","CS Northridge","UC Riverside",3,3,0.5,6
"2490","CS Northridge","USC",1,0,0,1
"2491","CS Northridge","Utah",0,1,1,1
"2492","CS Northridge","Bethesda",0,1,1,1
"2493","CS Northridge","Hope Intl",0,1,1,1
"2494","CS Northridge","La Sierra",0,1,1,1
"2495","CS Northridge","Vanguard",0,1,1,1
"2496","CS Sacramento","Arizona St",1,0,0,1
"2497","CS Sacramento","Cent Arkansas",0,1,1,1
"2498","CS Sacramento","CS Bakersfield",1,1,0.5,2
"2499","CS Sacramento","CS Fullerton",1,1,0.5,2
"2500","CS Sacramento","E Washington",3,4,0.571428571428571,7
"2501","CS Sacramento","Gonzaga",1,0,0,1
"2502","CS Sacramento","Idaho",1,1,0.5,2
"2503","CS Sacramento","Idaho St",2,3,0.6,5
"2504","CS Sacramento","Montana",4,1,0.2,5
"2505","CS Sacramento","Montana St",2,3,0.6,5
"2506","CS Sacramento","N Colorado",3,3,0.5,6
"2507","CS Sacramento","North Dakota",3,4,0.571428571428571,7
"2508","CS Sacramento","Northern Arizona",4,2,0.333333333333333,6
"2509","CS Sacramento","Portland",1,0,0,1
"2510","CS Sacramento","Portland St",2,5,0.714285714285714,7
"2511","CS Sacramento","San Jose St",1,0,0,1
"2512","CS Sacramento","Santa Barbara",0,1,1,1
"2513","CS Sacramento","Seattle",1,0,0,1
"2514","CS Sacramento","Southern Utah",2,4,0.666666666666667,6
"2515","CS Sacramento","UC Davis",1,1,0.5,2
"2516","CS Sacramento","UC Irvine",2,0,0,2
"2517","CS Sacramento","UCLA",1,0,0,1
"2518","CS Sacramento","UC Riverside",0,2,1,2
"2519","CS Sacramento","Utah",0,1,1,1
"2520","CS Sacramento","Utah Valley",0,2,1,2
"2521","CS Sacramento","UTEP",1,0,0,1
"2522","CS Sacramento","Weber St",3,2,0.4,5
"2523","CS Sacramento","Abilene Chr",1,0,0,1
"2524","CS Sacramento","Simpson CA",0,1,1,1
"2525","CS Sacramento","UC Santa Cruz",0,1,1,1
"2526","CS Sacramento","Wm Jessup",0,1,1,1
"2527","CS Sacramento","Bristol",0,1,1,1
"2528","Dartmouth","Arizona St",1,0,0,1
"2529","Dartmouth","Army",0,1,1,1
"2530","Dartmouth","Boston College",1,0,0,1
"2531","Dartmouth","Brown",4,2,0.333333333333333,6
"2532","Dartmouth","Bryant",2,1,0.333333333333333,3
"2533","Dartmouth","Bucknell",1,0,0,1
"2534","Dartmouth","Colgate",1,0,0,1
"2535","Dartmouth","Columbia",2,4,0.666666666666667,6
"2536","Dartmouth","Cornell",3,3,0.5,6
"2537","Dartmouth","Elon",1,0,0,1
"2538","Dartmouth","Hartford",2,0,0,2
"2539","Dartmouth","Harvard",5,1,0.166666666666667,6
"2540","Dartmouth","Holy Cross",1,0,0,1
"2541","Dartmouth","Illinois",1,0,0,1
"2542","Dartmouth","IPFW",2,1,0.333333333333333,3
"2543","Dartmouth","Jacksonville St",1,1,0.5,2
"2544","Dartmouth","Longwood",1,2,0.666666666666667,3
"2545","Dartmouth","Maine",0,3,1,3
"2546","Dartmouth","Mercer",0,1,1,1
"2547","Dartmouth","New Hampshire",2,1,0.333333333333333,3
"2548","Dartmouth","N Illinois",1,1,0.5,2
"2549","Dartmouth","NJIT",0,1,1,1
"2550","Dartmouth","Penn",3,3,0.5,6
"2551","Dartmouth","Penn St",1,0,0,1
"2552","Dartmouth","Princeton",5,1,0.166666666666667,6
"2553","Dartmouth","St Bonaventure",1,0,0,1
"2554","Dartmouth","St John's",1,0,0,1
"2555","Dartmouth","Vermont",3,0,0,3
"2556","Dartmouth","Yale",3,3,0.5,6
"2557","Dartmouth","Lesley",0,1,1,1
"2558","Dartmouth","Lyndon St",0,1,1,1
"2559","Dartmouth","MA Lowell",0,2,1,2
"2560","Davidson","Appalachian St",0,3,1,3
"2561","Davidson","Campbell",0,1,1,1
"2562","Davidson","Charlotte",1,2,0.666666666666667,3
"2563","Davidson","Chattanooga",0,2,1,2
"2564","Davidson","Citadel",0,4,1,4
"2565","Davidson","Clemson",1,0,0,1
"2566","Davidson","Col Charleston",1,3,0.75,4
"2567","Davidson","Dayton",0,1,1,1
"2568","Davidson","Drexel",2,0,0,2
"2569","Davidson","Duke",2,0,0,2
"2570","Davidson","Duquesne",0,2,1,2
"2571","Davidson","Elon",1,2,0.666666666666667,3
"2572","Davidson","Fordham",0,1,1,1
"2573","Davidson","Furman",0,4,1,4
"2574","Davidson","Ga Southern",1,3,0.75,4
"2575","Davidson","George Mason",0,2,1,2
"2576","Davidson","Georgia",0,1,1,1
"2577","Davidson","Gonzaga",1,0,0,1
"2578","Davidson","G Washington",0,2,1,2
"2579","Davidson","La Salle",0,2,1,2
"2580","Davidson","Massachusetts",0,1,1,1
"2581","Davidson","Montana",0,2,1,2
"2582","Davidson","New Mexico",2,0,0,2
"2583","Davidson","Niagara",1,1,0.5,2
"2584","Davidson","North Carolina",2,0,0,2
"2585","Davidson","Rhode Island",0,1,1,1
"2586","Davidson","Richmond",1,2,0.666666666666667,3
"2587","Davidson","Samford",0,3,1,3
"2588","Davidson","St Bonaventure",1,0,0,1
"2589","Davidson","Stetson",0,2,1,2
"2590","Davidson","St Joseph's PA",1,0,0,1
"2591","Davidson","St Louis",0,1,1,1
"2592","Davidson","UCF",0,1,1,1
"2593","Davidson","UNC Greensboro",0,3,1,3
"2594","Davidson","UNC Wilmington",0,2,1,2
"2595","Davidson","VA Commonwealth",2,1,0.333333333333333,3
"2596","Davidson","Vanderbilt",0,1,1,1
"2597","Davidson","Virginia",2,0,0,2
"2598","Davidson","W Carolina",1,3,0.75,4
"2599","Davidson","West Virginia",0,1,1,1
"2600","Davidson","Wichita St",1,0,0,1
"2601","Davidson","WI Milwaukee",2,0,0,2
"2602","Davidson","Wofford",0,4,1,4
"2603","Davidson","Catholic",0,1,1,1
"2604","Davidson","J&W NC",0,1,1,1
"2605","Dayton","Alabama",0,1,1,1
"2606","Dayton","Alabama A&M",0,1,1,1
"2607","Dayton","Arkansas",1,0,0,1
"2608","Dayton","Arkansas St",0,1,1,1
"2609","Dayton","Auburn",0,1,1,1
"2610","Dayton","Baylor",1,0,0,1
"2611","Dayton","Boston College",0,2,1,2
"2612","Dayton","Boston Univ",0,1,1,1
"2613","Dayton","Bowling Green",0,1,1,1
"2614","Dayton","Butler",1,0,0,1
"2615","Dayton","California",0,1,1,1
"2616","Dayton","Charlotte",0,1,1,1
"2617","Dayton","C Michigan",0,1,1,1
"2618","Dayton","Colorado",1,0,0,1
"2619","Dayton","Connecticut",1,0,0,1
"2620","Dayton","Davidson",1,0,0,1
"2621","Dayton","Delaware St",0,1,1,1
"2622","Dayton","Duquesne",1,3,0.75,4
"2623","Dayton","E Michigan",0,1,1,1
"2624","Dayton","FL Atlantic",0,1,1,1
"2625","Dayton","Fordham",0,5,1,5
"2626","Dayton","George Mason",0,2,1,2
"2627","Dayton","Georgia Tech",0,2,1,2
"2628","Dayton","Gonzaga",0,1,1,1
"2629","Dayton","G Washington",2,1,0.333333333333333,3
"2630","Dayton","IL Chicago",0,1,1,1
"2631","Dayton","Illinois St",2,0,0,2
"2632","Dayton","Iona",0,1,1,1
"2633","Dayton","IPFW",0,1,1,1
"2634","Dayton","La Salle",2,2,0.5,4
"2635","Dayton","Manhattan",0,1,1,1
"2636","Dayton","Massachusetts",2,1,0.333333333333333,3
"2637","Dayton","Miami OH",0,2,1,2
"2638","Dayton","Mississippi",0,2,1,2
"2639","Dayton","Murray St",0,2,1,2
"2640","Dayton","N Illinois",0,1,1,1
"2641","Dayton","Rhode Island",2,3,0.6,5
"2642","Dayton","Richmond",1,3,0.75,4
"2643","Dayton","St Bonaventure",0,5,1,5
"2644","Dayton","St Francis NY",0,1,1,1
"2645","Dayton","St Francis PA",0,1,1,1
"2646","Dayton","St Joseph's PA",3,2,0.4,5
"2647","Dayton","St Louis",2,3,0.6,5
"2648","Dayton","Temple",1,0,0,1
"2649","Dayton","Texas A&M",0,1,1,1
"2650","Dayton","UAB",0,1,1,1
"2651","Dayton","USC",2,0,0,2
"2652","Dayton","VA Commonwealth",3,1,0.25,4
"2653","Dayton","Weber St",1,0,0,1
"2654","Dayton","Winthrop",0,1,1,1
"2655","Dayton","Xavier",1,1,0.5,2
"2656","Delaware","Army",1,1,0.5,2
"2657","Delaware","Bryant",0,1,1,1
"2658","Delaware","Cal Poly SLO",1,1,0.5,2
"2659","Delaware","Charleston So",1,1,0.5,2
"2660","Delaware","Col Charleston",0,4,1,4
"2661","Delaware","CS Bakersfield",1,0,0,1
"2662","Delaware","Delaware St",2,1,0.333333333333333,3
"2663","Delaware","Drexel",2,4,0.666666666666667,6
"2664","Delaware","Duke",1,0,0,1
"2665","Delaware","Elon",2,0,0,2
"2666","Delaware","F Dickinson",1,0,0,1
"2667","Delaware","George Mason",0,2,1,2
"2668","Delaware","Georgia St",0,1,1,1
"2669","Delaware","Hampton",0,1,1,1
"2670","Delaware","Hofstra",2,5,0.714285714285714,7
"2671","Delaware","James Madison",4,2,0.333333333333333,6
"2672","Delaware","Kansas St",1,0,0,1
"2673","Delaware","Lafayette",1,0,0,1
"2674","Delaware","La Salle",1,0,0,1
"2675","Delaware","Liberty",1,1,0.5,2
"2676","Delaware","N Dakota St",1,0,0,1
"2677","Delaware","Northeastern",3,5,0.625,8
"2678","Delaware","Notre Dame",1,0,0,1
"2679","Delaware","Ohio St",1,0,0,1
"2680","Delaware","Old Dominion",0,2,1,2
"2681","Delaware","Penn",0,2,1,2
"2682","Delaware","Pittsburgh",1,0,0,1
"2683","Delaware","Radford",0,1,1,1
"2684","Delaware","Richmond",1,0,0,1
"2685","Delaware","Rider",0,1,1,1
"2686","Delaware","Robert Morris",1,1,0.5,2
"2687","Delaware","Stanford",1,0,0,1
"2688","Delaware","St Bonaventure",1,1,0.5,2
"2689","Delaware","Temple",2,0,0,2
"2690","Delaware","Towson",3,3,0.5,6
"2691","Delaware","UNC Wilmington",1,5,0.833333333333333,6
"2692","Delaware","Villanova",3,0,0,3
"2693","Delaware","Virginia",0,1,1,1
"2694","Delaware","William & Mary",0,6,1,6
"2695","Delaware St","Arkansas",2,0,0,2
"2696","Delaware St","Bethune-Cookman",1,2,0.666666666666667,3
"2697","Delaware St","Buffalo",1,0,0,1
"2698","Delaware St","Campbell",1,1,0.5,2
"2699","Delaware St","Clemson",1,0,0,1
"2700","Delaware St","Coppin St",3,2,0.4,5
"2701","Delaware St","Dayton",1,0,0,1
"2702","Delaware St","Delaware",1,2,0.666666666666667,3
"2703","Delaware St","E Kentucky",1,0,0,1
"2704","Delaware St","F Dickinson",1,0,0,1
"2705","Delaware St","Florida A&M",2,2,0.5,4
"2706","Delaware St","Gardner Webb",0,1,1,1
"2707","Delaware St","Georgia Tech",1,0,0,1
"2708","Delaware St","G Washington",1,0,0,1
"2709","Delaware St","Hampton",4,2,0.333333333333333,6
"2710","Delaware St","Hawaii",1,0,0,1
"2711","Delaware St","Howard",2,4,0.666666666666667,6
"2712","Delaware St","Illinois St",1,0,0,1
"2713","Delaware St","Iona",1,0,0,1
"2714","Delaware St","Marshall",0,1,1,1
"2715","Delaware St","Maryland",1,0,0,1
"2716","Delaware St","MD E Shore",3,3,0.5,6
"2717","Delaware St","Morgan St",3,2,0.4,5
"2718","Delaware St","Navy",1,0,0,1
"2719","Delaware St","NC A&T",1,2,0.666666666666667,3
"2720","Delaware St","NC Central",3,1,0.25,4
"2721","Delaware St","NJIT",2,0,0,2
"2722","Delaware St","Norfolk St",4,0,0,4
"2723","Delaware St","North Texas",1,0,0,1
"2724","Delaware St","Northwestern",1,0,0,1
"2725","Delaware St","Oklahoma St",1,0,0,1
"2726","Delaware St","Oregon",1,0,0,1
"2727","Delaware St","Penn",0,1,1,1
"2728","Delaware St","Penn St",1,0,0,1
"2729","Delaware St","Pittsburgh",1,0,0,1
"2730","Delaware St","Rhode Island",1,0,0,1
"2731","Delaware St","Savannah St",0,3,1,3
"2732","Delaware St","S Carolina St",2,2,0.5,4
"2733","Delaware St","St Francis NY",1,1,0.5,2
"2734","Delaware St","Temple",1,0,0,1
"2735","Delaware St","Wagner",0,1,1,1
"2736","Delaware St","Wake Forest",0,1,1,1
"2737","Delaware St","Bap Bible PA",0,2,1,2
"2738","Delaware St","Cairn",0,1,1,1
"2739","Delaware St","Cheyney St",0,1,1,1
"2740","Denver","Alcorn St",0,1,1,1
"2741","Denver","Belmont",1,1,0.5,2
"2742","Denver","Bryant",1,0,0,1
"2743","Denver","California",2,0,0,2
"2744","Denver","Colorado St",2,1,0.333333333333333,3
"2745","Denver","Coppin St",0,1,1,1
"2746","Denver","Harvard",1,0,0,1
"2747","Denver","Idaho",0,2,1,2
"2748","Denver","Idaho St",0,1,1,1
"2749","Denver","Iona",1,0,0,1
"2750","Denver","IPFW",3,1,0.25,4
"2751","Denver","IUPUI",3,1,0.25,4
"2752","Denver","Louisiana Tech",1,1,0.5,2
"2753","Denver","Mercer",1,1,0.5,2
"2754","Denver","N Dakota St",5,1,0.166666666666667,6
"2755","Denver","NE Omaha",1,4,0.8,5
"2756","Denver","New Mexico St",1,1,0.5,2
"2757","Denver","New Orleans",0,1,1,1
"2758","Denver","Northern Iowa",1,1,0.5,2
"2759","Denver","Oral Roberts",1,1,0.5,2
"2760","Denver","Pepperdine",1,0,0,1
"2761","Denver","San Jose St",0,2,1,2
"2762","Denver","S Dakota St",3,1,0.25,4
"2763","Denver","Seattle",0,2,1,2
"2764","Denver","South Dakota",2,3,0.6,5
"2765","Denver","Southern Miss",1,0,0,1
"2766","Denver","Southern Univ",0,1,1,1
"2767","Denver","Southern Utah",0,1,1,1
"2768","Denver","Stanford",3,0,0,3
"2769","Denver","St Francis PA",0,1,1,1
"2770","Denver","St Joseph's PA",1,1,0.5,2
"2771","Denver","St Mary's CA",1,0,0,1
"2772","Denver","TAM C. Christi",0,3,1,3
"2773","Denver","Texas St",0,2,1,2
"2774","Denver","UC Irvine",1,0,0,1
"2775","Denver","Utah St",0,2,1,2
"2776","Denver","UT Arlington",0,2,1,2
"2777","Denver","UTEP",1,0,0,1
"2778","Denver","UT San Antonio",0,2,1,2
"2779","Denver","W Illinois",0,4,1,4
"2780","Denver","Wyoming",2,1,0.333333333333333,3
"2781","Denver","AK Anchorage",0,1,1,1
"2782","DePaul","Arizona St",1,1,0.5,2
"2783","DePaul","Auburn",0,1,1,1
"2784","DePaul","Austin Peay",0,1,1,1
"2785","DePaul","Butler",3,1,0.25,4
"2786","DePaul","Chicago St",0,3,1,3
"2787","DePaul","Cincinnati",1,0,0,1
"2788","DePaul","Colorado",1,0,0,1
"2789","DePaul","Connecticut",2,0,0,2
"2790","DePaul","Creighton",5,1,0.166666666666667,6
"2791","DePaul","Drake",0,1,1,1
"2792","DePaul","Fairfield",0,1,1,1
"2793","DePaul","FL Atlantic",0,1,1,1
"2794","DePaul","Gardner Webb",1,0,0,1
"2795","DePaul","Georgetown",5,1,0.166666666666667,6
"2796","DePaul","Grambling",0,1,1,1
"2797","DePaul","G Washington",1,0,0,1
"2798","DePaul","Houston Bap",0,1,1,1
"2799","DePaul","IL Chicago",0,1,1,1
"2800","DePaul","Illinois St",2,0,0,2
"2801","DePaul","Lehigh",1,0,0,1
"2802","DePaul","Louisville",1,0,0,1
"2803","DePaul","Loy Marymount",1,0,0,1
"2804","DePaul","Loyola-Chicago",1,0,0,1
"2805","DePaul","Marquette",4,1,0.2,5
"2806","DePaul","MD Baltimore Co",0,1,1,1
"2807","DePaul","N Illinois",0,2,1,2
"2808","DePaul","Northwestern",0,1,1,1
"2809","DePaul","Notre Dame",2,0,0,2
"2810","DePaul","Ohio",1,0,0,1
"2811","DePaul","Oregon St",1,1,0.5,2
"2812","DePaul","Pittsburgh",2,0,0,2
"2813","DePaul","Providence",4,1,0.2,5
"2814","DePaul","Rutgers",0,1,1,1
"2815","DePaul","Seton Hall",2,3,0.6,5
"2816","DePaul","Southern Miss",1,0,0,1
"2817","DePaul","South Florida",1,0,0,1
"2818","DePaul","Stanford",0,1,1,1
"2819","DePaul","St John's",4,2,0.333333333333333,6
"2820","DePaul","Syracuse",1,0,0,1
"2821","DePaul","Texas",1,0,0,1
"2822","DePaul","UC Riverside",0,1,1,1
"2823","DePaul","Villanova",5,0,0,5
"2824","DePaul","Wichita St",2,0,0,2
"2825","DePaul","WI Milwaukee",0,3,1,3
"2826","DePaul","W Kentucky",1,0,0,1
"2827","DePaul","Wright St",0,1,1,1
"2828","DePaul","Xavier",3,1,0.25,4
"2829","Detroit","Akron",1,1,0.5,2
"2830","Detroit","Alabama St",0,1,1,1
"2831","Detroit","Alcorn St",0,1,1,1
"2832","Detroit","Arizona St",1,0,0,1
"2833","Detroit","Bethune-Cookman",0,1,1,1
"2834","Detroit","Bowling Green",3,0,0,3
"2835","Detroit","Canisius",0,1,1,1
"2836","Detroit","Cleveland St",5,2,0.285714285714286,7
"2837","Detroit","Connecticut",1,0,0,1
"2838","Detroit","Drake",0,1,1,1
"2839","Detroit","FL Atlantic",0,1,1,1
"2840","Detroit","IL Chicago",1,5,0.833333333333333,6
"2841","Detroit","James Madison",0,1,1,1
"2842","Detroit","Loyola-Chicago",0,2,1,2
"2843","Detroit","MD E Shore",0,1,1,1
"2844","Detroit","Miami FL",1,0,0,1
"2845","Detroit","Michigan",1,0,0,1
"2846","Detroit","NC State",1,0,0,1
"2847","Detroit","Northeastern",0,1,1,1
"2848","Detroit","Oakland",3,1,0.25,4
"2849","Detroit","Oral Roberts",1,0,0,1
"2850","Detroit","Oregon",1,0,0,1
"2851","Detroit","Pittsburgh",1,0,0,1
"2852","Detroit","Rhode Island",1,1,0.5,2
"2853","Detroit","South Alabama",1,1,0.5,2
"2854","Detroit","South Florida",0,2,1,2
"2855","Detroit","St John's",1,0,0,1
"2856","Detroit","Stony Brook",1,0,0,1
"2857","Detroit","Syracuse",1,0,0,1
"2858","Detroit","Temple",1,0,0,1
"2859","Detroit","Toledo",2,2,0.5,4
"2860","Detroit","UCF",1,0,0,1
"2861","Detroit","Valparaiso",3,3,0.5,6
"2862","Detroit","Wichita St",2,0,0,2
"2863","Detroit","WI Green Bay",5,1,0.166666666666667,6
"2864","Detroit","WI Milwaukee",3,4,0.571428571428571,7
"2865","Detroit","Wright St",4,2,0.333333333333333,6
"2866","Detroit","Youngstown St",1,6,0.857142857142857,7
"2867","Detroit","Indiana Tech",0,1,1,1
"2868","Detroit","MI Dearborn",0,1,1,1
"2869","Detroit","Rochester MI",0,1,1,1
"2870","Detroit","Aquinas",0,1,1,1
"2871","Drake","Albany NY",0,1,1,1
"2872","Drake","Bowling Green",1,0,0,1
"2873","Drake","Bradley",3,4,0.571428571428571,7
"2874","Drake","California",1,0,0,1
"2875","Drake","Creighton",1,1,0.5,2
"2876","Drake","CS Bakersfield",0,1,1,1
"2877","Drake","DePaul",1,0,0,1
"2878","Drake","Detroit",1,0,0,1
"2879","Drake","E Illinois",0,1,1,1
"2880","Drake","Evansville",4,3,0.428571428571429,7
"2881","Drake","Fresno St",0,1,1,1
"2882","Drake","IL Chicago",0,1,1,1
"2883","Drake","Illinois St",5,1,0.166666666666667,6
"2884","Drake","Indiana St",3,3,0.5,6
"2885","Drake","Iowa",1,0,0,1
"2886","Drake","Iowa St",2,0,0,2
"2887","Drake","IPFW",0,1,1,1
"2888","Drake","IUPUI",0,2,1,2
"2889","Drake","Jackson St",0,1,1,1
"2890","Drake","Loyola-Chicago",3,1,0.25,4
"2891","Drake","Missouri St",4,2,0.333333333333333,6
"2892","Drake","Murray St",1,0,0,1
"2893","Drake","NC Central",0,1,1,1
"2894","Drake","NE Omaha",0,1,1,1
"2895","Drake","Nevada",0,1,1,1
"2896","Drake","New Mexico St",1,0,0,1
"2897","Drake","North Dakota",1,0,0,1
"2898","Drake","Northern Arizona",0,1,1,1
"2899","Drake","Northern Iowa",5,1,0.166666666666667,6
"2900","Drake","Portland",1,0,0,1
"2901","Drake","Rice",0,1,1,1
"2902","Drake","S Illinois",3,3,0.5,6
"2903","Drake","St Mary's CA",2,0,0,2
"2904","Drake","Valparaiso",1,0,0,1
"2905","Drake","Wichita St",6,0,0,6
"2906","Drake","WI Green Bay",1,1,0.5,2
"2907","Drake","W Michigan",1,1,0.5,2
"2908","Drake","Xavier",1,0,0,1
"2909","Drake","Iowa Wesleyan",0,1,1,1
"2910","Drake","Simpson IA",0,1,1,1
"2911","Drexel","Alabama",0,1,1,1
"2912","Drexel","Arizona",1,0,0,1
"2913","Drexel","Buffalo",2,0,0,2
"2914","Drexel","Cleveland St",0,1,1,1
"2915","Drexel","Col Charleston",2,3,0.6,5
"2916","Drexel","Colorado",1,0,0,1
"2917","Drexel","Cornell",0,1,1,1
"2918","Drexel","Davidson",0,2,1,2
"2919","Drexel","Delaware",4,2,0.333333333333333,6
"2920","Drexel","Elon",1,2,0.666666666666667,3
"2921","Drexel","Fairfield",1,0,0,1
"2922","Drexel","George Mason",1,1,0.5,2
"2923","Drexel","Georgia St",0,2,1,2
"2924","Drexel","Hofstra",2,4,0.666666666666667,6
"2925","Drexel","Illinois St",1,1,0.5,2
"2926","Drexel","Iona",1,0,0,1
"2927","Drexel","James Madison",4,2,0.333333333333333,6
"2928","Drexel","Kent",1,0,0,1
"2929","Drexel","La Salle",1,0,0,1
"2930","Drexel","Miami FL",1,0,0,1
"2931","Drexel","Northeastern",5,2,0.285714285714286,7
"2932","Drexel","Old Dominion",1,1,0.5,2
"2933","Drexel","Penn",0,1,1,1
"2934","Drexel","Penn St",1,0,0,1
"2935","Drexel","Princeton",0,1,1,1
"2936","Drexel","Rice",0,1,1,1
"2937","Drexel","Rider",1,0,0,1
"2938","Drexel","Rutgers",0,1,1,1
"2939","Drexel","Southern Miss",1,1,0.5,2
"2940","Drexel","St Francis PA",0,1,1,1
"2941","Drexel","St Joseph's PA",3,0,0,3
"2942","Drexel","St Mary's CA",1,0,0,1
"2943","Drexel","Tennessee St",1,1,0.5,2
"2944","Drexel","Towson",4,2,0.333333333333333,6
"2945","Drexel","UCLA",1,0,0,1
"2946","Drexel","UNC Wilmington",1,4,0.8,5
"2947","Drexel","USC",1,0,0,1
"2948","Drexel","William & Mary",3,2,0.4,5
"2949","Drexel","Xavier",1,0,0,1
"2950","Drexel","Univ Sciences",1,0,0,1
"2951","Duke","Alabama",0,1,1,1
"2952","Duke","Arizona",1,0,0,1
"2953","Duke","Army",0,1,1,1
"2954","Duke","Boston College",0,4,1,4
"2955","Duke","Clemson",1,3,0.75,4
"2956","Duke","Connecticut",0,1,1,1
"2957","Duke","Cornell",0,1,1,1
"2958","Duke","Davidson",0,2,1,2
"2959","Duke","Delaware",0,1,1,1
"2960","Duke","East Carolina",0,1,1,1
"2961","Duke","Elon",0,3,1,3
"2962","Duke","E Michigan",0,1,1,1
"2963","Duke","Fairfield",0,1,1,1
"2964","Duke","FL Atlantic",0,1,1,1
"2965","Duke","FL Gulf Coast",0,1,1,1
"2966","Duke","Florida St",0,3,1,3
"2967","Duke","Furman",0,1,1,1
"2968","Duke","Gardner Webb",0,1,1,1
"2969","Duke","Georgia St",0,1,1,1
"2970","Duke","Georgia Tech",0,4,1,4
"2971","Duke","Kansas",1,0,0,1
"2972","Duke","Kentucky",0,1,1,1
"2973","Duke","Louisville",0,2,1,2
"2974","Duke","Maryland",1,2,0.666666666666667,3
"2975","Duke","Miami FL",2,2,0.5,4
"2976","Duke","Michigan",0,1,1,1
"2977","Duke","Michigan St",0,1,1,1
"2978","Duke","Minnesota",0,1,1,1
"2979","Duke","NC State",2,4,0.666666666666667,6
"2980","Duke","North Carolina",1,5,0.833333333333333,6
"2981","Duke","Notre Dame",3,1,0.25,4
"2982","Duke","Ohio St",0,1,1,1
"2983","Duke","Pittsburgh",0,2,1,2
"2984","Duke","Presbyterian",0,1,1,1
"2985","Duke","Santa Clara",0,1,1,1
"2986","Duke","Stanford",0,1,1,1
"2987","Duke","St John's",0,1,1,1
"2988","Duke","Syracuse",1,3,0.75,4
"2989","Duke","Temple",0,2,1,2
"2990","Duke","Toledo",0,1,1,1
"2991","Duke","UCLA",0,1,1,1
"2992","Duke","UNC Asheville",0,1,1,1
"2993","Duke","VA Commonwealth",0,1,1,1
"2994","Duke","Vermont",0,1,1,1
"2995","Duke","Virginia",2,2,0.5,4
"2996","Duke","Virginia Tech",0,4,1,4
"2997","Duke","Wake Forest",1,5,0.833333333333333,6
"2998","Duke","Wisconsin",0,1,1,1
"2999","Duke","Wofford",0,1,1,1
"3000","Duquesne","Albany NY",1,1,0.5,2
"3001","Duquesne","Appalachian St",0,2,1,2
"3002","Duquesne","Butler",1,0,0,1
"3003","Duquesne","Charlotte",1,0,0,1
"3004","Duquesne","Davidson",2,0,0,2
"3005","Duquesne","Dayton",3,1,0.25,4
"3006","Duquesne","Fordham",1,2,0.666666666666667,3
"3007","Duquesne","George Mason",1,2,0.666666666666667,3
"3008","Duquesne","Georgetown",1,0,0,1
"3009","Duquesne","G Washington",4,1,0.2,5
"3010","Duquesne","Howard",0,1,1,1
"3011","Duquesne","James Madison",0,1,1,1
"3012","Duquesne","La Salle",4,0,0,4
"3013","Duquesne","Maine",0,1,1,1
"3014","Duquesne","Massachusetts",3,0,0,3
"3015","Duquesne","MD E Shore",1,0,0,1
"3016","Duquesne","N Dakota St",1,0,0,1
"3017","Duquesne","New Hampshire",1,0,0,1
"3018","Duquesne","New Orleans",0,1,1,1
"3019","Duquesne","NJIT",1,1,0.5,2
"3020","Duquesne","Penn St",3,0,0,3
"3021","Duquesne","Pittsburgh",3,0,0,3
"3022","Duquesne","Rhode Island",2,1,0.333333333333333,3
"3023","Duquesne","Richmond",4,0,0,4
"3024","Duquesne","Robert Morris",3,0,0,3
"3025","Duquesne","St Bonaventure",5,1,0.166666666666667,6
"3026","Duquesne","St Francis PA",1,1,0.5,2
"3027","Duquesne","St Joseph's PA",2,1,0.333333333333333,3
"3028","Duquesne","St Louis",3,3,0.5,6
"3029","Duquesne","Temple",0,1,1,1
"3030","Duquesne","TX Pan American",0,2,1,2
"3031","Duquesne","ULL",1,0,0,1
"3032","Duquesne","VA Commonwealth",3,0,0,3
"3033","Duquesne","West Virginia",1,1,0.5,2
"3034","Duquesne","W Michigan",0,1,1,1
"3035","Duquesne","Xavier",1,0,0,1
"3036","Duquesne","Youngstown St",0,1,1,1
"3037","Duquesne","Abilene Chr",0,2,1,2
"3038","Duquesne","Bluefield WV",0,1,1,1
"3039","Duquesne","MA Lowell",0,2,1,2
"3040","Duquesne","UMBC",0,1,1,1
"3041","East Carolina","Appalachian St",0,1,1,1
"3042","East Carolina","Campbell",1,1,0.5,2
"3043","East Carolina","Central Conn",0,1,1,1
"3044","East Carolina","Charlotte",1,1,0.5,2
"3045","East Carolina","Cincinnati",1,1,0.5,2
"3046","East Carolina","Connecticut",2,0,0,2
"3047","East Carolina","Duke",1,0,0,1
"3048","East Carolina","FL Atlantic",2,0,0,2
"3049","East Carolina","Florida A&M",0,1,1,1
"3050","East Carolina","Florida Intl",1,0,0,1
"3051","East Carolina","Fresno St",0,1,1,1
"3052","East Carolina","Gardner Webb",0,1,1,1
"3053","East Carolina","Georgia St",1,1,0.5,2
"3054","East Carolina","Hawaii",1,0,0,1
"3055","East Carolina","Houston",1,2,0.666666666666667,3
"3056","East Carolina","James Madison",0,1,1,1
"3057","East Carolina","Louisiana Tech",0,1,1,1
"3058","East Carolina","Marshall",2,1,0.333333333333333,3
"3059","East Carolina","Massachusetts",1,0,0,1
"3060","East Carolina","McNeese St",0,1,1,1
"3061","East Carolina","Memphis",3,1,0.25,4
"3062","East Carolina","Middle Tenn St",1,0,0,1
"3063","East Carolina","NC A&T",0,1,1,1
"3064","East Carolina","NC State",1,0,0,1
"3065","East Carolina","Norfolk St",0,2,1,2
"3066","East Carolina","North Carolina",2,0,0,2
"3067","East Carolina","North Texas",1,0,0,1
"3068","East Carolina","Old Dominion",2,0,0,2
"3069","East Carolina","Rice",0,2,1,2
"3070","East Carolina","SMU",2,1,0.333333333333333,3
"3071","East Carolina","Southern Miss",3,0,0,3
"3072","East Carolina","South Florida",1,1,0.5,2
"3073","East Carolina","Temple",2,0,0,2
"3074","East Carolina","Tulane",2,1,0.333333333333333,3
"3075","East Carolina","Tulsa",3,1,0.25,4
"3076","East Carolina","UAB",0,3,1,3
"3077","East Carolina","UCF",1,4,0.8,5
"3078","East Carolina","UNC Asheville",1,1,0.5,2
"3079","East Carolina","UNC Greensboro",0,3,1,3
"3080","East Carolina","UNC Wilmington",2,0,0,2
"3081","East Carolina","UTEP",3,0,0,3
"3082","East Carolina","UT San Antonio",0,2,1,2
"3083","East Carolina","VMI",0,1,1,1
"3084","East Carolina","WI Green Bay",1,0,0,1
"3085","East Carolina","Chowan",0,1,1,1
"3086","East Carolina","Fayetteville St",0,1,1,1
"3087","East Carolina","Mt Olive",0,1,1,1
"3088","East Carolina","NC Wesleyan",0,2,1,2
"3089","East Carolina","VA-Lynchburg",0,1,1,1
"3090","Edwardsville","Arkansas",1,0,0,1
"3091","Edwardsville","Austin Peay",2,4,0.666666666666667,6
"3092","Edwardsville","Belmont",3,0,0,3
"3093","Edwardsville","Campbell",1,0,0,1
"3094","Edwardsville","Cent Arkansas",1,1,0.5,2
"3095","Edwardsville","Chicago St",1,2,0.666666666666667,3
"3096","Edwardsville","C Michigan",2,0,0,2
"3097","Edwardsville","E Illinois",5,2,0.285714285714286,7
"3098","Edwardsville","E Kentucky",2,1,0.333333333333333,3
"3099","Edwardsville","IPFW",2,0,0,2
"3100","Edwardsville","Jacksonville St",2,1,0.333333333333333,3
"3101","Edwardsville","Loyola-Chicago",1,0,0,1
"3102","Edwardsville","Missouri",1,0,0,1
"3103","Edwardsville","Morehead St",3,0,0,3
"3104","Edwardsville","Murray St",4,2,0.333333333333333,6
"3105","Edwardsville","N Illinois",1,0,0,1
"3106","Edwardsville","Oregon St",1,0,0,1
"3107","Edwardsville","Portland",1,0,0,1
"3108","Edwardsville","Portland St",2,0,0,2
"3109","Edwardsville","SE Missouri St",2,4,0.666666666666667,6
"3110","Edwardsville","S Illinois",3,0,0,3
"3111","Edwardsville","St Louis",3,0,0,3
"3112","Edwardsville","Tennessee St",2,1,0.333333333333333,3
"3113","Edwardsville","Tennessee Tech",2,2,0.5,4
"3114","Edwardsville","TN Martin",3,3,0.5,6
"3115","Edwardsville","TX Pan American",1,1,0.5,2
"3116","Edwardsville","UC Davis",1,0,0,1
"3117","Edwardsville","W Illinois",1,1,0.5,2
"3118","Edwardsville","WI Milwaukee",0,1,1,1
"3119","Edwardsville","Crowley's Ridge",0,1,1,1
"3120","Edwardsville","R Morris Spfd",0,2,1,2
"3121","Edwardsville","Harris-Stowe",0,1,1,1
"3122","E Illinois","Austin Peay",3,3,0.5,6
"3123","E Illinois","Ball St",0,1,1,1
"3124","E Illinois","Belmont",3,1,0.25,4
"3125","E Illinois","Bradley",1,0,0,1
"3126","E Illinois","Cent Arkansas",1,0,0,1
"3127","E Illinois","Chicago St",0,2,1,2
"3128","E Illinois","Cincinnati",1,0,0,1
"3129","E Illinois","Cleveland St",1,1,0.5,2
"3130","E Illinois","Creighton",1,0,0,1
"3131","E Illinois","Drake",1,0,0,1
"3132","E Illinois","Edwardsville",2,5,0.714285714285714,7
"3133","E Illinois","E Kentucky",2,1,0.333333333333333,3
"3134","E Illinois","E Michigan",1,0,0,1
"3135","E Illinois","Houston Bap",0,1,1,1
"3136","E Illinois","IL Chicago",0,1,1,1
"3137","E Illinois","Indiana St",1,1,0.5,2
"3138","E Illinois","IPFW",2,1,0.333333333333333,3
"3139","E Illinois","Jacksonville St",1,2,0.666666666666667,3
"3140","E Illinois","Missouri St",1,0,0,1
"3141","E Illinois","Morehead St",2,1,0.333333333333333,3
"3142","E Illinois","Murray St",5,1,0.166666666666667,6
"3143","E Illinois","NC Central",1,0,0,1
"3144","E Illinois","N Illinois",0,2,1,2
"3145","E Illinois","Northwestern",1,0,0,1
"3146","E Illinois","Purdue",1,0,0,1
"3147","E Illinois","SE Missouri St",4,3,0.428571428571429,7
"3148","E Illinois","Southern Univ",0,1,1,1
"3149","E Illinois","St Louis",1,0,0,1
"3150","E Illinois","Stony Brook",1,0,0,1
"3151","E Illinois","Tennessee St",1,2,0.666666666666667,3
"3152","E Illinois","Tennessee Tech",2,1,0.333333333333333,3
"3153","E Illinois","TN Martin",3,3,0.5,6
"3154","E Illinois","Toledo",1,0,0,1
"3155","E Illinois","TX Pan American",0,1,1,1
"3156","E Illinois","UC Davis",2,0,0,2
"3157","E Illinois","W Illinois",2,0,0,2
"3158","E Illinois","W Kentucky",1,0,0,1
"3159","E Illinois","Wright St",2,0,0,2
"3160","E Illinois","Eureka",0,1,1,1
"3161","E Illinois","Olivet Naz",0,1,1,1
"3162","E Illinois","Roosevelt",0,1,1,1
"3163","E Illinois","Baker KS",0,1,1,1
"3164","E Kentucky","Alabama A&M",0,1,1,1
"3165","E Kentucky","Austin Peay",0,3,1,3
"3166","E Kentucky","Belmont",5,3,0.375,8
"3167","E Kentucky","BYU",1,0,0,1
"3168","E Kentucky","Chattanooga",0,2,1,2
"3169","E Kentucky","Coppin St",0,1,1,1
"3170","E Kentucky","Delaware St",0,1,1,1
"3171","E Kentucky","Edwardsville",1,2,0.666666666666667,3
"3172","E Kentucky","E Illinois",1,2,0.666666666666667,3
"3173","E Kentucky","ETSU",1,0,0,1
"3174","E Kentucky","FL Atlantic",1,0,0,1
"3175","E Kentucky","Florida Intl",0,1,1,1
"3176","E Kentucky","High Point",0,2,1,2
"3177","E Kentucky","Illinois",1,0,0,1
"3178","E Kentucky","IPFW",0,1,1,1
"3179","E Kentucky","IUPUI",0,1,1,1
"3180","E Kentucky","Jacksonville St",1,5,0.833333333333333,6
"3181","E Kentucky","Kennesaw",0,2,1,2
"3182","E Kentucky","Kentucky",1,0,0,1
"3183","E Kentucky","Longwood",0,1,1,1
"3184","E Kentucky","Miami FL",0,1,1,1
"3185","E Kentucky","Morehead St",1,5,0.833333333333333,6
"3186","E Kentucky","Murray St",2,2,0.5,4
"3187","E Kentucky","NC A&T",1,1,0.5,2
"3188","E Kentucky","NC Central",0,1,1,1
"3189","E Kentucky","NC State",1,0,0,1
"3190","E Kentucky","Norfolk St",0,1,1,1
"3191","E Kentucky","Radford",0,1,1,1
"3192","E Kentucky","Savannah St",0,1,1,1
"3193","E Kentucky","S Carolina St",0,1,1,1
"3194","E Kentucky","SE Missouri St",0,4,1,4
"3195","E Kentucky","Southern Utah",0,1,1,1
"3196","E Kentucky","Tennessee St",1,5,0.833333333333333,6
"3197","E Kentucky","Tennessee Tech",2,4,0.666666666666667,6
"3198","E Kentucky","TN Martin",1,2,0.666666666666667,3
"3199","E Kentucky","Towson",0,1,1,1
"3200","E Kentucky","VA Commonwealth",1,0,0,1
"3201","E Kentucky","Valparaiso",2,0,0,2
"3202","E Kentucky","W Carolina",0,1,1,1
"3203","E Kentucky","West Virginia",1,0,0,1
"3204","E Kentucky","Wisconsin",1,0,0,1
"3205","E Kentucky","Youngstown St",1,0,0,1
"3206","E Kentucky","Brescia",0,1,1,1
"3207","E Kentucky","Warren Wilson",0,1,1,1
"3208","E Kentucky","Cin Clermont",0,1,1,1
"3209","E Kentucky","Kentucky Chr",0,1,1,1
"3210","Elon","Appalachian St",1,3,0.75,4
"3211","Elon","Butler",1,0,0,1
"3212","Elon","Canisius",1,0,0,1
"3213","Elon","Charlotte",2,0,0,2
"3214","Elon","Chattanooga",2,1,0.333333333333333,3
"3215","Elon","Citadel",0,2,1,2
"3216","Elon","Col Charleston",3,0,0,3
"3217","Elon","Colgate",0,1,1,1
"3218","Elon","Colorado",1,0,0,1
"3219","Elon","Columbia",0,2,1,2
"3220","Elon","Dartmouth",0,1,1,1
"3221","Elon","Davidson",2,1,0.333333333333333,3
"3222","Elon","Delaware",0,2,1,2
"3223","Elon","Drexel",2,1,0.333333333333333,3
"3224","Elon","Duke",3,0,0,3
"3225","Elon","FL Atlantic",0,3,1,3
"3226","Elon","Furman",0,3,1,3
"3227","Elon","Ga Southern",0,3,1,3
"3228","Elon","Georgetown",1,0,0,1
"3229","Elon","Georgia St",0,1,1,1
"3230","Elon","Hofstra",2,0,0,2
"3231","Elon","James Madison",2,0,0,2
"3232","Elon","Kennesaw",0,1,1,1
"3233","Elon","Marist",0,2,1,2
"3234","Elon","Massachusetts",2,0,0,2
"3235","Elon","Miami OH",0,1,1,1
"3236","Elon","Missouri",1,0,0,1
"3237","Elon","Morgan St",0,1,1,1
"3238","Elon","Northeastern",1,1,0.5,2
"3239","Elon","North Florida",1,0,0,1
"3240","Elon","Northwestern",1,0,0,1
"3241","Elon","Princeton",1,0,0,1
"3242","Elon","Samford",1,3,0.75,4
"3243","Elon","South Carolina",0,1,1,1
"3244","Elon","Towson",2,1,0.333333333333333,3
"3245","Elon","UNC Greensboro",0,5,1,5
"3246","Elon","UNC Wilmington",1,1,0.5,2
"3247","Elon","VMI",1,1,0.5,2
"3248","Elon","W Carolina",2,3,0.6,5
"3249","Elon","William & Mary",2,1,0.333333333333333,3
"3250","Elon","Wofford",2,1,0.333333333333333,3
"3251","Elon","Central Penn",0,2,1,2
"3252","Elon","Metro St",1,0,0,1
"3253","Elon","VA-Lynchburg",0,1,1,1
"3254","Elon","Wash & Lee",0,1,1,1
"3255","E Michigan","Akron",3,1,0.25,4
"3256","E Michigan","Ball St",2,4,0.666666666666667,6
"3257","E Michigan","Bowling Green",2,3,0.6,5
"3258","E Michigan","Buffalo",2,2,0.5,4
"3259","E Michigan","Cleveland St",0,1,1,1
"3260","E Michigan","C Michigan",3,4,0.571428571428571,7
"3261","E Michigan","Coppin St",0,1,1,1
"3262","E Michigan","Dayton",1,0,0,1
"3263","E Michigan","Duke",1,0,0,1
"3264","E Michigan","E Illinois",0,1,1,1
"3265","E Michigan","IL Chicago",1,0,0,1
"3266","E Michigan","IPFW",0,1,1,1
"3267","E Michigan","Jacksonville St",1,0,0,1
"3268","E Michigan","Kent",2,1,0.333333333333333,3
"3269","E Michigan","Kentucky",2,0,0,2
"3270","E Michigan","Longwood",0,1,1,1
"3271","E Michigan","Massachusetts",2,0,0,2
"3272","E Michigan","Miami OH",2,3,0.6,5
"3273","E Michigan","Michigan",1,1,0.5,2
"3274","E Michigan","Michigan St",1,0,0,1
"3275","E Michigan","Missouri St",1,1,0.5,2
"3276","E Michigan","N Illinois",1,6,0.857142857142857,7
"3277","E Michigan","Oakland",1,2,0.666666666666667,3
"3278","E Michigan","Ohio",3,1,0.25,4
"3279","E Michigan","Purdue",1,1,0.5,2
"3280","E Michigan","Robert Morris",0,1,1,1
"3281","E Michigan","Syracuse",2,0,0,2
"3282","E Michigan","Toledo",6,2,0.25,8
"3283","E Michigan","TX Pan American",0,1,1,1
"3284","E Michigan","UNC Greensboro",0,1,1,1
"3285","E Michigan","UT Arlington",0,1,1,1
"3286","E Michigan","WI Green Bay",0,1,1,1
"3287","E Michigan","W Michigan",3,3,0.5,6
"3288","E Michigan","Youngstown St",0,1,1,1
"3289","E Michigan","Albion",0,1,1,1
"3290","E Michigan","Concordia MI",0,2,1,2
"3291","E Michigan","Marygrove",0,1,1,1
"3292","E Michigan","Rochester MI",0,2,1,2
"3293","E Michigan","St Francis IL",0,1,1,1
"3294","ETSU","Arizona",1,0,0,1
"3295","ETSU","Austin Peay",0,2,1,2
"3296","ETSU","Charleston So",1,1,0.5,2
"3297","ETSU","Charlotte",1,0,0,1
"3298","ETSU","Chattanooga",2,0,0,2
"3299","ETSU","Citadel",1,1,0.5,2
"3300","ETSU","E Kentucky",0,1,1,1
"3301","ETSU","FL Gulf Coast",3,2,0.4,5
"3302","ETSU","Furman",1,1,0.5,2
"3303","ETSU","Georgia",1,0,0,1
"3304","ETSU","Georgia Tech",1,0,0,1
"3305","ETSU","Hawaii",1,0,0,1
"3306","ETSU","Jacksonville",2,2,0.5,4
"3307","ETSU","James Madison",1,0,0,1
"3308","ETSU","Kennesaw",0,4,1,4
"3309","ETSU","Lipscomb",2,3,0.6,5
"3310","ETSU","Marshall",0,1,1,1
"3311","ETSU","Mercer",5,1,0.166666666666667,6
"3312","ETSU","Mississippi",1,0,0,1
"3313","ETSU","Morehead St",1,1,0.5,2
"3314","ETSU","NC Central",0,1,1,1
"3315","ETSU","N Kentucky",1,3,0.75,4
"3316","ETSU","North Carolina",1,0,0,1
"3317","ETSU","North Florida",1,3,0.75,4
"3318","ETSU","Samford",1,2,0.666666666666667,3
"3319","ETSU","San Francisco",1,0,0,1
"3320","ETSU","SC Upstate",4,0,0,4
"3321","ETSU","SF Austin",0,1,1,1
"3322","ETSU","Stetson",2,2,0.5,4
"3323","ETSU","Tennessee",1,0,0,1
"3324","ETSU","Tennessee Tech",2,1,0.333333333333333,3
"3325","ETSU","UNC Asheville",0,1,1,1
"3326","ETSU","UNC Greensboro",1,1,0.5,2
"3327","ETSU","VA Commonwealth",2,0,0,2
"3328","ETSU","Valparaiso",1,1,0.5,2
"3329","ETSU","Virginia Tech",1,0,0,1
"3330","ETSU","VMI",1,1,0.5,2
"3331","ETSU","W Carolina",1,2,0.666666666666667,3
"3332","ETSU","Winthrop",1,1,0.5,2
"3333","ETSU","W Kentucky",1,0,0,1
"3334","ETSU","Wofford",2,0,0,2
"3335","ETSU","Tusculum",0,2,1,2
"3336","ETSU","UVA-Wise",0,1,1,1
"3337","Evansville","Alabama A&M",0,1,1,1
"3338","Evansville","Alabama St",0,2,1,2
"3339","Evansville","Belmont",0,1,1,1
"3340","Evansville","Bradley",3,3,0.5,6
"3341","Evansville","Buffalo",1,0,0,1
"3342","Evansville","Butler",2,0,0,2
"3343","Evansville","Colorado St",1,0,0,1
"3344","Evansville","Coppin St",0,1,1,1
"3345","Evansville","Creighton",2,0,0,2
"3346","Evansville","Drake",3,4,0.571428571428571,7
"3347","Evansville","Fresno St",0,1,1,1
"3348","Evansville","Grambling",0,1,1,1
"3349","Evansville","Illinois St",5,2,0.285714285714286,7
"3350","Evansville","Indiana",1,0,0,1
"3351","Evansville","Indiana St",4,2,0.333333333333333,6
"3352","Evansville","IUPUI",0,2,1,2
"3353","Evansville","Jackson St",1,0,0,1
"3354","Evansville","Loyola-Chicago",1,3,0.75,4
"3355","Evansville","Mercer",0,1,1,1
"3356","Evansville","Miami OH",0,3,1,3
"3357","Evansville","Missouri St",3,3,0.5,6
"3358","Evansville","Murray St",3,0,0,3
"3359","Evansville","Northern Iowa",3,3,0.5,6
"3360","Evansville","Notre Dame",1,0,0,1
"3361","Evansville","Ohio",1,1,0.5,2
"3362","Evansville","San Francisco",0,1,1,1
"3363","Evansville","S Illinois",2,4,0.666666666666667,6
"3364","Evansville","Tennessee Tech",0,1,1,1
"3365","Evansville","Valparaiso",0,1,1,1
"3366","Evansville","Wichita St",5,2,0.285714285714286,7
"3367","Evansville","WI Green Bay",1,0,0,1
"3368","Evansville","W Illinois",0,1,1,1
"3369","Evansville","Wright St",0,2,1,2
"3370","Evansville","Xavier",1,0,0,1
"3371","Evansville","Yale",0,1,1,1
"3372","Evansville","Anderson IN",0,1,1,1
"3373","Evansville","Earlham",0,1,1,1
"3374","Evansville","Martin Meth",0,1,1,1
"3375","E Washington","Boston Univ",0,1,1,1
"3376","E Washington","California",1,0,0,1
"3377","E Washington","Connecticut",1,0,0,1
"3378","E Washington","CS Fullerton",0,1,1,1
"3379","E Washington","CS Northridge",1,0,0,1
"3380","E Washington","CS Sacramento",4,3,0.428571428571429,7
"3381","E Washington","Idaho",1,3,0.75,4
"3382","E Washington","Idaho St",1,5,0.833333333333333,6
"3383","E Washington","Indiana",0,1,1,1
"3384","E Washington","Long Island",0,1,1,1
"3385","E Washington","Montana",4,3,0.428571428571429,7
"3386","E Washington","Montana St",1,5,0.833333333333333,6
"3387","E Washington","N Colorado",2,3,0.6,5
"3388","E Washington","N Kentucky",0,1,1,1
"3389","E Washington","North Dakota",4,1,0.2,5
"3390","E Washington","Northern Arizona",2,3,0.6,5
"3391","E Washington","Portland St",4,2,0.333333333333333,6
"3392","E Washington","Sam Houston St",1,1,0.5,2
"3393","E Washington","San Francisco",0,1,1,1
"3394","E Washington","Santa Clara",1,0,0,1
"3395","E Washington","SC Upstate",0,1,1,1
"3396","E Washington","Seattle",1,2,0.666666666666667,3
"3397","E Washington","Seton Hall",1,0,0,1
"3398","E Washington","SMU",1,0,0,1
"3399","E Washington","Southern Utah",1,4,0.8,5
"3400","E Washington","St Mary's CA",2,0,0,2
"3401","E Washington","TX Southern",0,1,1,1
"3402","E Washington","UC Davis",1,0,0,1
"3403","E Washington","UC Irvine",2,0,0,2
"3404","E Washington","Utah Valley",1,1,0.5,2
"3405","E Washington","Washington",2,0,0,2
"3406","E Washington","Washington St",1,0,0,1
"3407","E Washington","Weber St",4,2,0.333333333333333,6
"3408","E Washington","Pacific OR",0,1,1,1
"3409","E Washington","Walla Walla",0,2,1,2
"3410","E Washington","Eastern Oregon",0,1,1,1
"3411","E Washington","Lewis-Clark ID",0,1,1,1
"3412","Fairfield","Albany NY",2,0,0,2
"3413","Fairfield","Austin Peay",0,1,1,1
"3414","Fairfield","Belmont",2,0,0,2
"3415","Fairfield","Bucknell",1,1,0.5,2
"3416","Fairfield","Canisius",5,1,0.166666666666667,6
"3417","Fairfield","Central Conn",0,2,1,2
"3418","Fairfield","DePaul",1,0,0,1
"3419","Fairfield","Drexel",0,1,1,1
"3420","Fairfield","Duke",1,0,0,1
"3421","Fairfield","Fordham",0,1,1,1
"3422","Fairfield","Hartford",1,0,0,1
"3423","Fairfield","Holy Cross",1,0,0,1
"3424","Fairfield","Iona",5,1,0.166666666666667,6
"3425","Fairfield","Lehigh",1,0,0,1
"3426","Fairfield","Louisville",1,0,0,1
"3427","Fairfield","Loyola MD",4,0,0,4
"3428","Fairfield","Manhattan",4,2,0.333333333333333,6
"3429","Fairfield","Marist",3,3,0.5,6
"3430","Fairfield","Monmouth NJ",3,1,0.25,4
"3431","Fairfield","Niagara",5,1,0.166666666666667,6
"3432","Fairfield","Northeastern",1,1,0.5,2
"3433","Fairfield","Old Dominion",0,1,1,1
"3434","Fairfield","Penn",0,1,1,1
"3435","Fairfield","Providence",2,0,0,2
"3436","Fairfield","Quinnipiac",3,1,0.25,4
"3437","Fairfield","Richmond",1,0,0,1
"3438","Fairfield","Rider",4,2,0.333333333333333,6
"3439","Fairfield","Sacred Heart",0,1,1,1
"3440","Fairfield","Sam Houston St",1,0,0,1
"3441","Fairfield","Siena",3,3,0.5,6
"3442","Fairfield","South Dakota",0,1,1,1
"3443","Fairfield","St Joseph's PA",0,1,1,1
"3444","Fairfield","St Peter's",5,3,0.375,8
"3445","Fairfield","Virginia",1,0,0,1
"3446","Fairfield","WI Green Bay",1,0,0,1
"3447","Fairfield","WI Milwaukee",0,1,1,1
"3448","Fairfield","Wofford",1,0,0,1
"3449","F Dickinson","Arizona",1,0,0,1
"3450","F Dickinson","Bryant",4,1,0.2,5
"3451","F Dickinson","Central Conn",2,3,0.6,5
"3452","F Dickinson","Columbia",2,0,0,2
"3453","F Dickinson","Delaware",0,1,1,1
"3454","F Dickinson","Delaware St",0,1,1,1
"3455","F Dickinson","Hartford",2,0,0,2
"3456","F Dickinson","Hofstra",1,1,0.5,2
"3457","F Dickinson","Illinois St",1,0,0,1
"3458","F Dickinson","Iowa",1,0,0,1
"3459","F Dickinson","Lafayette",1,1,0.5,2
"3460","F Dickinson","Lehigh",1,0,0,1
"3461","F Dickinson","Long Island",3,2,0.4,5
"3462","F Dickinson","Longwood",0,1,1,1
"3463","F Dickinson","Monmouth NJ",2,0,0,2
"3464","F Dickinson","Mt St Mary's",4,2,0.333333333333333,6
"3465","F Dickinson","NJIT",1,0,0,1
"3466","F Dickinson","Norfolk St",1,0,0,1
"3467","F Dickinson","Northwestern",1,0,0,1
"3468","F Dickinson","Notre Dame",1,0,0,1
"3469","F Dickinson","Prairie View",0,1,1,1
"3470","F Dickinson","Princeton",1,1,0.5,2
"3471","F Dickinson","Quinnipiac",1,0,0,1
"3472","F Dickinson","Robert Morris",6,0,0,6
"3473","F Dickinson","Rutgers",1,1,0.5,2
"3474","F Dickinson","Sacred Heart",4,1,0.2,5
"3475","F Dickinson","Seton Hall",0,1,1,1
"3476","F Dickinson","St Francis NY",5,1,0.166666666666667,6
"3477","F Dickinson","St Francis PA",5,1,0.166666666666667,6
"3478","F Dickinson","St John's",1,0,0,1
"3479","F Dickinson","St Joseph's PA",0,1,1,1
"3480","F Dickinson","Stony Brook",1,0,0,1
"3481","F Dickinson","St Peter's",2,1,0.333333333333333,3
"3482","F Dickinson","Towson",0,1,1,1
"3483","F Dickinson","VA Commonwealth",1,0,0,1
"3484","F Dickinson","Vermont",1,0,0,1
"3485","F Dickinson","Wagner",6,0,0,6
"3486","F Dickinson","Xavier",1,0,0,1
"3487","F Dickinson","Caldwell",0,1,1,1
"3488","F Dickinson","Metro St",1,0,0,1
"3489","F Dickinson","FDU Madison",0,1,1,1
"3490","FL Atlantic","American Univ",0,1,1,1
"3491","FL Atlantic","Arkansas St",1,1,0.5,2
"3492","FL Atlantic","Ark Little Rock",1,1,0.5,2
"3493","FL Atlantic","Boston College",1,0,0,1
"3494","FL Atlantic","Charlotte",2,0,0,2
"3495","FL Atlantic","Coppin St",0,1,1,1
"3496","FL Atlantic","Dayton",1,0,0,1
"3497","FL Atlantic","DePaul",1,0,0,1
"3498","FL Atlantic","Detroit",1,0,0,1
"3499","FL Atlantic","Duke",1,0,0,1
"3500","FL Atlantic","East Carolina",0,2,1,2
"3501","FL Atlantic","E Kentucky",0,1,1,1
"3502","FL Atlantic","Elon",3,0,0,3
"3503","FL Atlantic","Florida Intl",5,1,0.166666666666667,6
"3504","FL Atlantic","Georgia",1,0,0,1
"3505","FL Atlantic","Harvard",1,1,0.5,2
"3506","FL Atlantic","Hofstra",0,1,1,1
"3507","FL Atlantic","Indiana",1,0,0,1
"3508","FL Atlantic","Jacksonville",0,2,1,2
"3509","FL Atlantic","Louisiana Tech",2,0,0,2
"3510","FL Atlantic","Marshall",2,2,0.5,4
"3511","FL Atlantic","Maryland",1,0,0,1
"3512","FL Atlantic","Middle Tenn St",3,0,0,3
"3513","FL Atlantic","Mississippi St",1,0,0,1
"3514","FL Atlantic","North Carolina",1,0,0,1
"3515","FL Atlantic","North Texas",4,0,0,4
"3516","FL Atlantic","Old Dominion",2,0,0,2
"3517","FL Atlantic","Rice",1,1,0.5,2
"3518","FL Atlantic","South Alabama",2,0,0,2
"3519","FL Atlantic","Southern Miss",2,0,0,2
"3520","FL Atlantic","Stetson",2,2,0.5,4
"3521","FL Atlantic","St Francis NY",2,0,0,2
"3522","FL Atlantic","Stony Brook",1,0,0,1
"3523","FL Atlantic","Toledo",1,0,0,1
"3524","FL Atlantic","Troy",0,2,1,2
"3525","FL Atlantic","Tulane",1,0,0,1
"3526","FL Atlantic","Tulsa",1,0,0,1
"3527","FL Atlantic","UAB",1,2,0.666666666666667,3
"3528","FL Atlantic","UCF",0,2,1,2
"3529","FL Atlantic","ULL",1,1,0.5,2
"3530","FL Atlantic","ULM",1,1,0.5,2
"3531","FL Atlantic","UTEP",1,1,0.5,2
"3532","FL Atlantic","UT San Antonio",2,0,0,2
"3533","FL Atlantic","W Kentucky",2,2,0.5,4
"3534","FL Atlantic","Ave Maria",0,2,1,2
"3535","FL Atlantic","Warner",0,2,1,2
"3536","FL Atlantic","MTSU",2,0,0,2
"3537","FL Gulf Coast","Alcorn St",0,1,1,1
"3538","FL Gulf Coast","Duke",1,0,0,1
"3539","FL Gulf Coast","ETSU",2,3,0.6,5
"3540","FL Gulf Coast","Florida A&M",0,1,1,1
"3541","FL Gulf Coast","Florida Intl",2,1,0.333333333333333,3
"3542","FL Gulf Coast","Furman",0,2,1,2
"3543","FL Gulf Coast","Hartford",0,1,1,1
"3544","FL Gulf Coast","Iona",2,0,0,2
"3545","FL Gulf Coast","Iowa St",1,0,0,1
"3546","FL Gulf Coast","Jacksonville",2,5,0.714285714285714,7
"3547","FL Gulf Coast","Kennesaw",0,6,1,6
"3548","FL Gulf Coast","Lipscomb",3,3,0.5,6
"3549","FL Gulf Coast","Loyola MD",0,1,1,1
"3550","FL Gulf Coast","Maine",1,0,0,1
"3551","FL Gulf Coast","Marist",0,1,1,1
"3552","FL Gulf Coast","Massachusetts",0,1,1,1
"3553","FL Gulf Coast","Mercer",3,3,0.5,6
"3554","FL Gulf Coast","Miami FL",0,1,1,1
"3555","FL Gulf Coast","Mississippi St",1,0,0,1
"3556","FL Gulf Coast","NC State",1,0,0,1
"3557","FL Gulf Coast","Nebraska",1,0,0,1
"3558","FL Gulf Coast","N Kentucky",0,6,1,6
"3559","FL Gulf Coast","North Florida",2,4,0.666666666666667,6
"3560","FL Gulf Coast","Ohio",0,1,1,1
"3561","FL Gulf Coast","Pittsburgh",1,0,0,1
"3562","FL Gulf Coast","Radford",1,0,0,1
"3563","FL Gulf Coast","Samford",0,2,1,2
"3564","FL Gulf Coast","San Francisco",0,1,1,1
"3565","FL Gulf Coast","Santa Barbara",1,1,0.5,2
"3566","FL Gulf Coast","SC Upstate",1,6,0.857142857142857,7
"3567","FL Gulf Coast","S Dakota St",0,1,1,1
"3568","FL Gulf Coast","South Florida",1,0,0,1
"3569","FL Gulf Coast","Stetson",1,6,0.857142857142857,7
"3570","FL Gulf Coast","St John's",1,0,0,1
"3571","FL Gulf Coast","Toledo",0,1,1,1
"3572","FL Gulf Coast","VA Commonwealth",1,0,0,1
"3573","FL Gulf Coast","WI Green Bay",1,0,0,1
"3574","FL Gulf Coast","Xavier",1,0,0,1
"3575","FL Gulf Coast","Ave Maria",0,2,1,2
"3576","FL Gulf Coast","Eckerd",0,1,1,1
"3577","FL Gulf Coast","Nova SE",0,1,1,1
"3578","FL Gulf Coast","Florida Tech",0,1,1,1
"3579","Florida","Air Force",0,1,1,1
"3580","Florida","Alabama",0,5,1,5
"3581","Florida","Alabama St",0,1,1,1
"3582","Florida","Arizona",1,0,0,1
"3583","Florida","Arkansas",1,3,0.75,4
"3584","Florida","Ark Little Rock",0,1,1,1
"3585","Florida","Auburn",0,4,1,4
"3586","Florida","Connecticut",2,0,0,2
"3587","Florida","Florida St",1,2,0.666666666666667,3
"3588","Florida","Fresno St",0,1,1,1
"3589","Florida","Georgetown",1,0,0,1
"3590","Florida","Georgia",1,3,0.75,4
"3591","Florida","Jacksonville",0,2,1,2
"3592","Florida","Kansas",1,1,0.5,2
"3593","Florida","Kansas St",1,0,0,1
"3594","Florida","Kentucky",4,4,0.5,8
"3595","Florida","LSU",2,2,0.5,4
"3596","Florida","Marquette",0,1,1,1
"3597","Florida","Memphis",0,1,1,1
"3598","Florida","Miami FL",1,0,0,1
"3599","Florida","Middle Tenn St",0,2,1,2
"3600","Florida","Mississippi",2,2,0.5,4
"3601","Florida","Mississippi St",0,4,1,4
"3602","Florida","Missouri",2,3,0.6,5
"3603","Florida","North Carolina",1,0,0,1
"3604","Florida","North Florida",0,1,1,1
"3605","Florida","Richmond",0,1,1,1
"3606","Florida","Savannah St",0,2,1,2
"3607","Florida","SE Louisiana",0,1,1,1
"3608","Florida","South Carolina",0,4,1,4
"3609","Florida","Southern Univ",0,1,1,1
"3610","Florida","Tennessee",1,4,0.8,5
"3611","Florida","Texas A&M",1,3,0.75,4
"3612","Florida","TX Southern",0,1,1,1
"3613","Florida","UAB",0,1,1,1
"3614","Florida","UCF",0,1,1,1
"3615","Florida","ULM",0,1,1,1
"3616","Florida","Vanderbilt",1,3,0.75,4
"3617","Florida","Wake Forest",0,1,1,1
"3618","Florida","William & Mary",0,1,1,1
"3619","Florida","Wisconsin",1,1,0.5,2
"3620","Florida","Yale",0,2,1,2
"3621","Florida A&M","Arizona St",1,0,0,1
"3622","Florida A&M","Arkansas",1,0,0,1
"3623","Florida A&M","Auburn",1,0,0,1
"3624","Florida A&M","Bethune-Cookman",4,2,0.333333333333333,6
"3625","Florida A&M","Clemson",2,0,0,2
"3626","Florida A&M","Coppin St",1,1,0.5,2
"3627","Florida A&M","Delaware St",2,2,0.5,4
"3628","Florida A&M","East Carolina",1,0,0,1
"3629","Florida A&M","FL Gulf Coast",1,0,0,1
"3630","Florida A&M","Florida Intl",2,1,0.333333333333333,3
"3631","Florida A&M","Georgia",1,0,0,1
"3632","Florida A&M","Hampton",3,0,0,3
"3633","Florida A&M","Houston",1,0,0,1
"3634","Florida A&M","Howard",2,1,0.333333333333333,3
"3635","Florida A&M","Jacksonville",2,0,0,2
"3636","Florida A&M","Longwood",1,0,0,1
"3637","Florida A&M","MD E Shore",1,1,0.5,2
"3638","Florida A&M","Mississippi St",1,0,0,1
"3639","Florida A&M","Morgan St",3,1,0.25,4
"3640","Florida A&M","NC A&T",4,2,0.333333333333333,6
"3641","Florida A&M","NC Central",5,1,0.166666666666667,6
"3642","Florida A&M","N Colorado",1,0,0,1
"3643","Florida A&M","New Mexico St",1,0,0,1
"3644","Florida A&M","Norfolk St",3,0,0,3
"3645","Florida A&M","North Florida",2,0,0,2
"3646","Florida A&M","Presbyterian",0,1,1,1
"3647","Florida A&M","Princeton",1,0,0,1
"3648","Florida A&M","Rutgers",1,0,0,1
"3649","Florida A&M","Sacred Heart",0,1,1,1
"3650","Florida A&M","San Diego",1,0,0,1
"3651","Florida A&M","Savannah St",4,2,0.333333333333333,6
"3652","Florida A&M","S Carolina St",2,3,0.6,5
"3653","Florida A&M","SC Upstate",1,0,0,1
"3654","Florida A&M","South Florida",1,0,0,1
"3655","Florida A&M","Stetson",3,1,0.25,4
"3656","Florida A&M","Texas Tech",1,0,0,1
"3657","Florida A&M","Toledo",1,0,0,1
"3658","Florida A&M","UAB",1,0,0,1
"3659","Florida A&M","UCF",1,0,0,1
"3660","Florida A&M","Wyoming",1,0,0,1
"3661","Florida A&M","Edward Waters",0,1,1,1
"3662","Florida A&M","FL Memorial",0,1,1,1
"3663","Florida A&M","Grand Canyon",1,0,0,1
"3664","Florida Intl","Arkansas St",0,2,1,2
"3665","Florida Intl","Ark Little Rock",1,1,0.5,2
"3666","Florida Intl","Bethune-Cookman",0,2,1,2
"3667","Florida Intl","Boston College",1,0,0,1
"3668","Florida Intl","Charlotte",1,1,0.5,2
"3669","Florida Intl","Coastal Car",0,1,1,1
"3670","Florida Intl","CS Fullerton",1,0,0,1
"3671","Florida Intl","East Carolina",0,1,1,1
"3672","Florida Intl","E Kentucky",1,0,0,1
"3673","Florida Intl","FL Atlantic",1,5,0.833333333333333,6
"3674","Florida Intl","FL Gulf Coast",1,2,0.666666666666667,3
"3675","Florida Intl","Florida A&M",1,2,0.666666666666667,3
"3676","Florida Intl","Ga Southern",1,0,0,1
"3677","Florida Intl","Georgetown",1,0,0,1
"3678","Florida Intl","Georgia St",0,1,1,1
"3679","Florida Intl","Hartford",1,0,0,1
"3680","Florida Intl","Kennesaw",0,2,1,2
"3681","Florida Intl","Long Island",1,0,0,1
"3682","Florida Intl","Louisiana Tech",2,0,0,2
"3683","Florida Intl","Louisville",3,0,0,3
"3684","Florida Intl","Marshall",2,1,0.333333333333333,3
"3685","Florida Intl","Middle Tenn St",3,0,0,3
"3686","Florida Intl","North Texas",3,1,0.25,4
"3687","Florida Intl","Old Dominion",2,0,0,2
"3688","Florida Intl","Rice",0,2,1,2
"3689","Florida Intl","SC Upstate",1,0,0,1
"3690","Florida Intl","SF Austin",1,0,0,1
"3691","Florida Intl","South Alabama",2,0,0,2
"3692","Florida Intl","South Carolina",1,0,0,1
"3693","Florida Intl","Southern Miss",1,1,0.5,2
"3694","Florida Intl","Stetson",0,3,1,3
"3695","Florida Intl","Troy",1,1,0.5,2
"3696","Florida Intl","Tulane",0,1,1,1
"3697","Florida Intl","Tulsa",1,0,0,1
"3698","Florida Intl","TX Southern",0,2,1,2
"3699","Florida Intl","UAB",1,2,0.666666666666667,3
"3700","Florida Intl","ULL",0,2,1,2
"3701","Florida Intl","ULM",0,2,1,2
"3702","Florida Intl","UTEP",3,0,0,3
"3703","Florida Intl","UT San Antonio",1,2,0.666666666666667,3
"3704","Florida Intl","W Kentucky",3,1,0.25,4
"3705","Florida Intl","Wright St",0,1,1,1
"3706","Florida Intl","Youngstown St",1,0,0,1
"3707","Florida Intl","FL Memorial",0,1,1,1
"3708","Florida Intl","Florida Col",0,2,1,2
"3709","Florida Intl","Nova SE",1,0,0,1
"3710","Florida Intl","Warren Wilson",0,1,1,1
"3711","Florida Intl","MTSU",1,1,0.5,2
"3712","Florida St","Auburn",1,0,0,1
"3713","Florida St","Boston College",0,3,1,3
"3714","Florida St","Buffalo",0,1,1,1
"3715","Florida St","BYU",0,1,1,1
"3716","Florida St","Charleston So",0,2,1,2
"3717","Florida St","Charlotte",0,2,1,2
"3718","Florida St","Citadel",0,1,1,1
"3719","Florida St","Clemson",2,5,0.714285714285714,7
"3720","Florida St","Duke",3,0,0,3
"3721","Florida St","Florida",2,1,0.333333333333333,3
"3722","Florida St","Georgia Tech",0,3,1,3
"3723","Florida St","Jacksonville",0,1,1,1
"3724","Florida St","Jacksonville St",0,1,1,1
"3725","Florida St","Louisville",1,0,0,1
"3726","Florida St","Maine",0,1,1,1
"3727","Florida St","Manhattan",0,1,1,1
"3728","Florida St","Maryland",1,4,0.8,5
"3729","Florida St","Massachusetts",1,1,0.5,2
"3730","Florida St","Mercer",1,0,0,1
"3731","Florida St","Miami FL",4,2,0.333333333333333,6
"3732","Florida St","Michigan",1,0,0,1
"3733","Florida St","Minnesota",2,0,0,2
"3734","Florida St","Mississippi St",1,0,0,1
"3735","Florida St","NC State",3,1,0.25,4
"3736","Florida St","Nebraska",1,0,0,1
"3737","Florida St","North Carolina",4,0,0,4
"3738","Florida St","Northeastern",1,1,0.5,2
"3739","Florida St","North Florida",0,2,1,2
"3740","Florida St","Notre Dame",1,1,0.5,2
"3741","Florida St","Pittsburgh",1,2,0.666666666666667,3
"3742","Florida St","Providence",1,0,0,1
"3743","Florida St","South Alabama",1,0,0,1
"3744","Florida St","South Florida",0,1,1,1
"3745","Florida St","Stetson",0,1,1,1
"3746","Florida St","St Joseph's PA",0,1,1,1
"3747","Florida St","Syracuse",2,0,0,2
"3748","Florida St","TN Martin",0,1,1,1
"3749","Florida St","Tulsa",0,1,1,1
"3750","Florida St","UCF",0,2,1,2
"3751","Florida St","ULM",0,1,1,1
"3752","Florida St","VA Commonwealth",0,1,1,1
"3753","Florida St","Virginia",6,1,0.142857142857143,7
"3754","Florida St","Virginia Tech",1,3,0.75,4
"3755","Florida St","Wake Forest",1,3,0.75,4
"3756","Fordham","Butler",1,0,0,1
"3757","Fordham","Charlotte",1,0,0,1
"3758","Fordham","Colgate",0,1,1,1
"3759","Fordham","Connecticut",1,0,0,1
"3760","Fordham","Davidson",1,0,0,1
"3761","Fordham","Dayton",5,0,0,5
"3762","Fordham","Duquesne",2,1,0.333333333333333,3
"3763","Fordham","Fairfield",1,0,0,1
"3764","Fordham","Furman",0,1,1,1
"3765","Fordham","George Mason",0,4,1,4
"3766","Fordham","Georgia Tech",1,0,0,1
"3767","Fordham","G Washington",4,0,0,4
"3768","Fordham","Harvard",2,0,0,2
"3769","Fordham","Howard",0,2,1,2
"3770","Fordham","La Salle",3,1,0.25,4
"3771","Fordham","Lehigh",1,1,0.5,2
"3772","Fordham","Loyola-Chicago",0,1,1,1
"3773","Fordham","Manhattan",2,1,0.333333333333333,3
"3774","Fordham","Maryland",1,0,0,1
"3775","Fordham","Massachusetts",4,0,0,4
"3776","Fordham","MD E Shore",1,0,0,1
"3777","Fordham","Mississippi",1,0,0,1
"3778","Fordham","Monmouth NJ",1,2,0.666666666666667,3
"3779","Fordham","Penn",0,1,1,1
"3780","Fordham","Penn St",1,0,0,1
"3781","Fordham","Pittsburgh",1,0,0,1
"3782","Fordham","Princeton",0,1,1,1
"3783","Fordham","Rhode Island",3,2,0.4,5
"3784","Fordham","Richmond",4,0,0,4
"3785","Fordham","Robert Morris",1,0,0,1
"3786","Fordham","Sacred Heart",1,0,0,1
"3787","Fordham","S Carolina St",0,1,1,1
"3788","Fordham","Siena",1,2,0.666666666666667,3
"3789","Fordham","St Bonaventure",2,1,0.333333333333333,3
"3790","Fordham","St Francis PA",0,1,1,1
"3791","Fordham","St John's",3,0,0,3
"3792","Fordham","St Joseph's PA",4,1,0.2,5
"3793","Fordham","St Louis",2,1,0.333333333333333,3
"3794","Fordham","Syracuse",1,0,0,1
"3795","Fordham","Temple",1,0,0,1
"3796","Fordham","Texas St",1,0,0,1
"3797","Fordham","VA Commonwealth",5,0,0,5
"3798","Fordham","Xavier",1,0,0,1
"3799","Fordham","MA Lowell",1,0,0,1
"3800","Fordham","NYIT",0,1,1,1
"3801","Fresno St","Air Force",1,5,0.833333333333333,6
"3802","Fresno St","Boise St",4,2,0.333333333333333,6
"3803","Fresno St","California",2,0,0,2
"3804","Fresno St","Cal Poly SLO",0,3,1,3
"3805","Fresno St","Colorado",1,0,0,1
"3806","Fresno St","Colorado St",6,1,0.142857142857143,7
"3807","Fresno St","CS Bakersfield",0,2,1,2
"3808","Fresno St","CS Northridge",0,1,1,1
"3809","Fresno St","Drake",1,0,0,1
"3810","Fresno St","East Carolina",1,0,0,1
"3811","Fresno St","Evansville",1,0,0,1
"3812","Fresno St","Florida",1,0,0,1
"3813","Fresno St","Long Beach St",1,1,0.5,2
"3814","Fresno St","Marist",1,0,0,1
"3815","Fresno St","Nevada",2,4,0.666666666666667,6
"3816","Fresno St","New Mexico",5,1,0.166666666666667,6
"3817","Fresno St","Northern Arizona",1,1,0.5,2
"3818","Fresno St","Pacific",2,1,0.333333333333333,3
"3819","Fresno St","Pepperdine",1,0,0,1
"3820","Fresno St","Pittsburgh",1,0,0,1
"3821","Fresno St","San Diego St",5,1,0.166666666666667,6
"3822","Fresno St","San Jose St",0,4,1,4
"3823","Fresno St","S Illinois",1,0,0,1
"3824","Fresno St","Texas",1,0,0,1
"3825","Fresno St","Texas Tech",1,0,0,1
"3826","Fresno St","UC Irvine",1,2,0.666666666666667,3
"3827","Fresno St","UCLA",1,0,0,1
"3828","Fresno St","UC Riverside",0,1,1,1
"3829","Fresno St","UNLV",3,2,0.4,5
"3830","Fresno St","Utah",1,0,0,1
"3831","Fresno St","Utah St",1,2,0.666666666666667,3
"3832","Fresno St","Washington St",1,0,0,1
"3833","Fresno St","Wyoming",3,3,0.5,6
"3834","Fresno St","San Diego Chr",0,1,1,1
"3835","Fresno St","St Katherine",0,1,1,1
"3836","Fresno St","UC Merced",0,1,1,1
"3837","Fresno St","Bristol",0,1,1,1
"3838","Furman","Appalachian St",1,2,0.666666666666667,3
"3839","Furman","Auburn",1,0,0,1
"3840","Furman","California",1,0,0,1
"3841","Furman","Chattanooga",5,1,0.166666666666667,6
"3842","Furman","Citadel",3,4,0.571428571428571,7
"3843","Furman","Clemson",2,0,0,2
"3844","Furman","Col Charleston",4,0,0,4
"3845","Furman","Columbia",1,0,0,1
"3846","Furman","Davidson",4,0,0,4
"3847","Furman","Duke",1,0,0,1
"3848","Furman","Elon",3,0,0,3
"3849","Furman","ETSU",1,1,0.5,2
"3850","Furman","FL Gulf Coast",2,0,0,2
"3851","Furman","Fordham",1,0,0,1
"3852","Furman","Gardner Webb",1,1,0.5,2
"3853","Furman","Ga Southern",4,1,0.2,5
"3854","Furman","Jacksonville",1,0,0,1
"3855","Furman","Liberty",1,1,0.5,2
"3856","Furman","Loyola-Chicago",1,0,0,1
"3857","Furman","Mercer",3,1,0.25,4
"3858","Furman","Minnesota",1,0,0,1
"3859","Furman","Presbyterian",0,2,1,2
"3860","Furman","Samford",4,1,0.2,5
"3861","Furman","SMU",1,0,0,1
"3862","Furman","TCU",1,0,0,1
"3863","Furman","UC Davis",1,1,0.5,2
"3864","Furman","UNC Greensboro",3,2,0.4,5
"3865","Furman","Virginia Tech",1,0,0,1
"3866","Furman","VMI",2,0,0,2
"3867","Furman","Wake Forest",1,0,0,1
"3868","Furman","W Carolina",3,1,0.25,4
"3869","Furman","Wofford",6,1,0.142857142857143,7
"3870","Furman","Allen",0,1,1,1
"3871","Furman","Brevard",0,1,1,1
"3872","Furman","Mars Hill",1,0,0,1
"3873","Furman","Sewanee",0,1,1,1
"3874","Furman","St Andrew's",0,1,1,1
"3875","Gardner Webb","Arizona",1,0,0,1
"3876","Gardner Webb","Austin Peay",0,1,1,1
"3877","Gardner Webb","Campbell",2,3,0.6,5
"3878","Gardner Webb","Charleston So",2,4,0.666666666666667,6
"3879","Gardner Webb","Citadel",0,2,1,2
"3880","Gardner Webb","Clemson",0,1,1,1
"3881","Gardner Webb","Coastal Car",3,4,0.571428571428571,7
"3882","Gardner Webb","Col Charleston",0,2,1,2
"3883","Gardner Webb","Delaware St",1,0,0,1
"3884","Gardner Webb","DePaul",0,1,1,1
"3885","Gardner Webb","Duke",1,0,0,1
"3886","Gardner Webb","East Carolina",1,0,0,1
"3887","Gardner Webb","Furman",1,1,0.5,2
"3888","Gardner Webb","Georgia",1,0,0,1
"3889","Gardner Webb","High Point",3,2,0.4,5
"3890","Gardner Webb","Howard",0,1,1,1
"3891","Gardner Webb","Illinois",1,0,0,1
"3892","Gardner Webb","Iowa",1,0,0,1
"3893","Gardner Webb","IUPUI",0,1,1,1
"3894","Gardner Webb","Jacksonville",1,1,0.5,2
"3895","Gardner Webb","Liberty",0,3,1,3
"3896","Gardner Webb","Lipscomb",1,0,0,1
"3897","Gardner Webb","Longwood",0,5,1,5
"3898","Gardner Webb","LSU",1,0,0,1
"3899","Gardner Webb","Missouri",1,0,0,1
"3900","Gardner Webb","Morehead St",0,1,1,1
"3901","Gardner Webb","North Carolina",1,0,0,1
"3902","Gardner Webb","Northwestern",1,0,0,1
"3903","Gardner Webb","Old Dominion",1,0,0,1
"3904","Gardner Webb","Presbyterian",1,4,0.8,5
"3905","Gardner Webb","Purdue",0,1,1,1
"3906","Gardner Webb","Radford",2,2,0.5,4
"3907","Gardner Webb","Seton Hall",1,0,0,1
"3908","Gardner Webb","Tennessee Tech",0,1,1,1
"3909","Gardner Webb","UNC Asheville",4,2,0.333333333333333,6
"3910","Gardner Webb","VMI",2,1,0.333333333333333,3
"3911","Gardner Webb","Winthrop",2,4,0.666666666666667,6
"3912","Gardner Webb","Wofford",2,0,0,2
"3913","Gardner Webb","Xavier",1,0,0,1
"3914","Gardner Webb","Allen",0,1,1,1
"3915","Gardner Webb","Brevard",0,1,1,1
"3916","Gardner Webb","Clearwater Chr",0,1,1,1
"3917","Gardner Webb","Hiwassee",0,2,1,2
"3918","Gardner Webb","Thomas GA",0,1,1,1
"3919","Gardner Webb","Toccoa Falls",0,1,1,1
"3920","Ga Southern","Appalachian St",3,2,0.4,5
"3921","Ga Southern","Arkansas St",0,2,1,2
"3922","Ga Southern","Ark Little Rock",0,2,1,2
"3923","Ga Southern","Bradley",1,0,0,1
"3924","Ga Southern","Campbell",2,0,0,2
"3925","Ga Southern","Charlotte",1,0,0,1
"3926","Ga Southern","Chattanooga",0,3,1,3
"3927","Ga Southern","Citadel",2,2,0.5,4
"3928","Ga Southern","Col Charleston",1,1,0.5,2
"3929","Ga Southern","Davidson",3,1,0.25,4
"3930","Ga Southern","Elon",3,0,0,3
"3931","Ga Southern","Florida Intl",0,1,1,1
"3932","Ga Southern","Furman",1,4,0.8,5
"3933","Ga Southern","Georgia St",3,2,0.4,5
"3934","Ga Southern","Illinois",1,0,0,1
"3935","Ga Southern","Kennesaw",0,2,1,2
"3936","Ga Southern","Maryland",1,0,0,1
"3937","Ga Southern","Miami FL",1,0,0,1
"3938","Ga Southern","MS Valley St",0,1,1,1
"3939","Ga Southern","NC A&T",1,1,0.5,2
"3940","Ga Southern","North Florida",1,0,0,1
"3941","Ga Southern","Old Dominion",1,0,0,1
"3942","Ga Southern","Oral Roberts",1,0,0,1
"3943","Ga Southern","Presbyterian",0,1,1,1
"3944","Ga Southern","Samford",1,1,0.5,2
"3945","Ga Southern","S Carolina St",0,2,1,2
"3946","Ga Southern","South Alabama",0,2,1,2
"3947","Ga Southern","South Florida",0,1,1,1
"3948","Ga Southern","Stetson",0,1,1,1
"3949","Ga Southern","Texas St",0,2,1,2
"3950","Ga Southern","Troy",2,0,0,2
"3951","Ga Southern","UAB",2,0,0,2
"3952","Ga Southern","UCF",1,0,0,1
"3953","Ga Southern","ULL",1,1,0.5,2
"3954","Ga Southern","ULM",1,2,0.666666666666667,3
"3955","Ga Southern","UNC Greensboro",1,2,0.666666666666667,3
"3956","Ga Southern","UT Arlington",1,1,0.5,2
"3957","Ga Southern","Valparaiso",1,0,0,1
"3958","Ga Southern","Virginia Tech",0,1,1,1
"3959","Ga Southern","W Carolina",2,1,0.333333333333333,3
"3960","Ga Southern","West Virginia",1,0,0,1
"3961","Ga Southern","Wofford",5,0,0,5
"3962","Ga Southern","Brewton-Parker",0,1,1,1
"3963","Ga Southern","Toccoa Falls",0,1,1,1
"3964","Ga Southern","Trinity FL",0,1,1,1
"3965","Ga Southern","Truett-McConnell",0,1,1,1
"3966","Ga Southern","Johnson FL",0,1,1,1
"3967","George Mason","American Univ",0,1,1,1
"3968","George Mason","Boston Univ",0,1,1,1
"3969","George Mason","Bucknell",1,0,0,1
"3970","George Mason","Col Charleston",1,0,0,1
"3971","George Mason","Cornell",1,0,0,1
"3972","George Mason","Davidson",2,0,0,2
"3973","George Mason","Dayton",2,0,0,2
"3974","George Mason","Delaware",2,0,0,2
"3975","George Mason","Drexel",1,1,0.5,2
"3976","George Mason","Duquesne",2,1,0.333333333333333,3
"3977","George Mason","Fordham",4,0,0,4
"3978","George Mason","Georgia St",1,0,0,1
"3979","George Mason","G Washington",4,0,0,4
"3980","George Mason","Hofstra",0,2,1,2
"3981","George Mason","Iona",1,1,0.5,2
"3982","George Mason","Iowa St",1,0,0,1
"3983","George Mason","James Madison",0,2,1,2
"3984","George Mason","Lamar",0,1,1,1
"3985","George Mason","La Salle",0,2,1,2
"3986","George Mason","Manhattan",0,1,1,1
"3987","George Mason","Maryland",1,0,0,1
"3988","George Mason","Massachusetts",2,1,0.333333333333333,3
"3989","George Mason","MD Baltimore Co",0,1,1,1
"3990","George Mason","Mercer",0,1,1,1
"3991","George Mason","New Mexico",2,0,0,2
"3992","George Mason","Northeastern",2,0,0,2
"3993","George Mason","Northern Iowa",2,1,0.333333333333333,3
"3994","George Mason","Oklahoma",2,0,0,2
"3995","George Mason","Old Dominion",2,2,0.5,4
"3996","George Mason","Oregon St",1,0,0,1
"3997","George Mason","Penn",0,1,1,1
"3998","George Mason","Princeton",1,1,0.5,2
"3999","George Mason","Quinnipiac",0,1,1,1
"4000","George Mason","Rhode Island",2,2,0.5,4
"4001","George Mason","Richmond",1,3,0.75,4
"4002","George Mason","South Florida",2,0,0,2
"4003","George Mason","St Bonaventure",2,0,0,2
"4004","George Mason","St Francis PA",0,1,1,1
"4005","George Mason","St Joseph's PA",2,0,0,2
"4006","George Mason","St Louis",2,2,0.5,4
"4007","George Mason","St Mary's CA",0,1,1,1
"4008","George Mason","Towson",1,1,0.5,2
"4009","George Mason","UNC Wilmington",1,0,0,1
"4010","George Mason","VA Commonwealth",3,0,0,3
"4011","George Mason","Virginia",0,1,1,1
"4012","George Mason","West Virginia",1,0,0,1
"4013","George Mason","William & Mary",0,2,1,2
"4014","George Mason","Wright St",0,1,1,1
"4015","George Mason","Catawba",0,1,1,1
"4016","Georgetown","American Univ",0,1,1,1
"4017","Georgetown","Butler",1,4,0.8,5
"4018","Georgetown","Charlotte",0,1,1,1
"4019","Georgetown","Cincinnati",0,1,1,1
"4020","Georgetown","Colgate",0,1,1,1
"4021","Georgetown","Connecticut",0,1,1,1
"4022","Georgetown","Creighton",1,4,0.8,5
"4023","Georgetown","DePaul",1,5,0.833333333333333,6
"4024","Georgetown","Duquesne",0,1,1,1
"4025","Georgetown","Elon",0,1,1,1
"4026","Georgetown","Florida",0,1,1,1
"4027","Georgetown","Florida Intl",0,1,1,1
"4028","Georgetown","High Point",0,1,1,1
"4029","Georgetown","Indiana",1,1,0.5,2
"4030","Georgetown","Kansas",2,0,0,2
"4031","Georgetown","Kansas St",0,1,1,1
"4032","Georgetown","Liberty",0,1,1,1
"4033","Georgetown","Lipscomb",0,1,1,1
"4034","Georgetown","Longwood",0,1,1,1
"4035","Georgetown","Louisville",0,1,1,1
"4036","Georgetown","Marquette",3,3,0.5,6
"4037","Georgetown","Michigan St",0,1,1,1
"4038","Georgetown","Mt St Mary's",0,1,1,1
"4039","Georgetown","Northeastern",1,0,0,1
"4040","Georgetown","Notre Dame",0,1,1,1
"4041","Georgetown","Oregon",1,0,0,1
"4042","Georgetown","Pittsburgh",1,0,0,1
"4043","Georgetown","Providence",3,2,0.4,5
"4044","Georgetown","Radford",0,1,1,1
"4045","Georgetown","Robert Morris",0,1,1,1
"4046","Georgetown","Rutgers",0,2,1,2
"4047","Georgetown","Seton Hall",2,3,0.6,5
"4048","Georgetown","South Florida",1,0,0,1
"4049","Georgetown","St Francis NY",0,1,1,1
"4050","Georgetown","St John's",2,4,0.666666666666667,6
"4051","Georgetown","Syracuse",0,2,1,2
"4052","Georgetown","TAM C. Christi",0,1,1,1
"4053","Georgetown","Tennessee",0,1,1,1
"4054","Georgetown","Texas",0,1,1,1
"4055","Georgetown","Towson",0,2,1,2
"4056","Georgetown","UCLA",0,1,1,1
"4057","Georgetown","VA Commonwealth",0,1,1,1
"4058","Georgetown","Villanova",4,1,0.2,5
"4059","Georgetown","W Carolina",0,1,1,1
"4060","Georgetown","Wisconsin",1,0,0,1
"4061","Georgetown","Wright St",0,1,1,1
"4062","Georgetown","Xavier",4,1,0.2,5
"4063","Georgia","Alabama",2,2,0.5,4
"4064","Georgia","Appalachian St",0,1,1,1
"4065","Georgia","Arkansas",4,1,0.2,5
"4066","Georgia","Auburn",2,2,0.5,4
"4067","Georgia","Chattanooga",0,2,1,2
"4068","Georgia","Colorado",1,1,0.5,2
"4069","Georgia","Davidson",1,0,0,1
"4070","Georgia","ETSU",0,1,1,1
"4071","Georgia","FL Atlantic",0,1,1,1
"4072","Georgia","Florida",3,1,0.25,4
"4073","Georgia","Florida A&M",0,1,1,1
"4074","Georgia","Gardner Webb",0,1,1,1
"4075","Georgia","Georgia Tech",3,0,0,3
"4076","Georgia","Gonzaga",1,0,0,1
"4077","Georgia","G Washington",1,1,0.5,2
"4078","Georgia","Indiana",1,0,0,1
"4079","Georgia","Iona",1,0,0,1
"4080","Georgia","Jacksonville",0,1,1,1
"4081","Georgia","Kansas St",0,1,1,1
"4082","Georgia","Kentucky",4,1,0.2,5
"4083","Georgia","Lipscomb",0,1,1,1
"4084","Georgia","LSU",1,3,0.75,4
"4085","Georgia","Mercer",0,2,1,2
"4086","Georgia","Minnesota",1,0,0,1
"4087","Georgia","Mississippi",1,4,0.8,5
"4088","Georgia","Mississippi St",1,3,0.75,4
"4089","Georgia","Missouri",1,3,0.75,4
"4090","Georgia","Nebraska",1,0,0,1
"4091","Georgia","Norfolk St",0,1,1,1
"4092","Georgia","Seton Hall",0,1,1,1
"4093","Georgia","South Carolina",2,5,0.714285714285714,7
"4094","Georgia","Southern Miss",1,0,0,1
"4095","Georgia","South Florida",1,0,0,1
"4096","Georgia","Stony Brook",0,1,1,1
"4097","Georgia","Temple",1,0,0,1
"4098","Georgia","Tennessee",1,3,0.75,4
"4099","Georgia","Texas A&M",0,4,1,4
"4100","Georgia","Troy",0,1,1,1
"4101","Georgia","UCLA",1,0,0,1
"4102","Georgia","USC",0,1,1,1
"4103","Georgia","Vanderbilt",2,2,0.5,4
"4104","Georgia","W Carolina",0,1,1,1
"4105","Georgia","Wofford",0,1,1,1
"4106","Georgia","Youngstown St",1,0,0,1
"4107","Georgia St","Alabama",1,0,0,1
"4108","Georgia St","Appalachian St",1,1,0.5,2
"4109","Georgia St","Arkansas St",0,5,1,5
"4110","Georgia St","Ark Little Rock",1,3,0.75,4
"4111","Georgia St","BYU",1,0,0,1
"4112","Georgia St","Canisius",1,0,0,1
"4113","Georgia St","Chicago St",0,1,1,1
"4114","Georgia St","Colorado St",1,0,0,1
"4115","Georgia St","Delaware",1,0,0,1
"4116","Georgia St","Drexel",2,0,0,2
"4117","Georgia St","Duke",1,0,0,1
"4118","Georgia St","East Carolina",1,1,0.5,2
"4119","Georgia St","Elon",1,0,0,1
"4120","Georgia St","Florida Intl",1,0,0,1
"4121","Georgia St","Ga Southern",2,3,0.6,5
"4122","Georgia St","George Mason",0,1,1,1
"4123","Georgia St","Hofstra",1,1,0.5,2
"4124","Georgia St","Iowa St",1,0,0,1
"4125","Georgia St","IUPUI",0,1,1,1
"4126","Georgia St","James Madison",0,2,1,2
"4127","Georgia St","Liberty",0,1,1,1
"4128","Georgia St","Louisiana Tech",1,0,0,1
"4129","Georgia St","McNeese St",0,1,1,1
"4130","Georgia St","Monmouth NJ",0,1,1,1
"4131","Georgia St","Northeastern",1,1,0.5,2
"4132","Georgia St","Oakland",0,1,1,1
"4133","Georgia St","Old Dominion",1,3,0.75,4
"4134","Georgia St","Rhode Island",1,0,0,1
"4135","Georgia St","South Alabama",0,5,1,5
"4136","Georgia St","Southern Miss",2,1,0.333333333333333,3
"4137","Georgia St","Tennessee St",0,1,1,1
"4138","Georgia St","Texas St",1,3,0.75,4
"4139","Georgia St","Towson",1,1,0.5,2
"4140","Georgia St","Troy",2,3,0.6,5
"4141","Georgia St","ULL",1,5,0.833333333333333,6
"4142","Georgia St","ULM",0,4,1,4
"4143","Georgia St","UNC Wilmington",1,1,0.5,2
"4144","Georgia St","UT Arlington",0,4,1,4
"4145","Georgia St","UT San Antonio",0,1,1,1
"4146","Georgia St","Vanderbilt",1,0,0,1
"4147","Georgia St","W Carolina",0,1,1,1
"4148","Georgia St","WI Green Bay",1,1,0.5,2
"4149","Georgia St","William & Mary",1,1,0.5,2
"4150","Georgia St","W Kentucky",0,2,1,2
"4151","Georgia St","Southern Poly",0,1,1,1
"4152","Georgia St","TN Temple",0,1,1,1
"4153","Georgia St","Young Harris",0,1,1,1
"4154","Georgia Tech","Alabama A&M",0,1,1,1
"4155","Georgia Tech","Alabama St",0,1,1,1
"4156","Georgia Tech","Appalachian St",0,1,1,1
"4157","Georgia Tech","Boston College",3,3,0.5,6
"4158","Georgia Tech","California",1,0,0,1
"4159","Georgia Tech","Charlotte",0,2,1,2
"4160","Georgia Tech","Chattanooga",0,1,1,1
"4161","Georgia Tech","Citadel",0,1,1,1
"4162","Georgia Tech","Clemson",6,1,0.142857142857143,7
"4163","Georgia Tech","Dayton",2,0,0,2
"4164","Georgia Tech","Delaware St",0,1,1,1
"4165","Georgia Tech","Duke",4,0,0,4
"4166","Georgia Tech","ETSU",0,1,1,1
"4167","Georgia Tech","Florida St",3,0,0,3
"4168","Georgia Tech","Fordham",0,1,1,1
"4169","Georgia Tech","Georgia",0,3,1,3
"4170","Georgia Tech","Illinois",1,1,0.5,2
"4171","Georgia Tech","IPFW",0,1,1,1
"4172","Georgia Tech","Kennesaw",0,1,1,1
"4173","Georgia Tech","Louisville",1,0,0,1
"4174","Georgia Tech","Marquette",1,0,0,1
"4175","Georgia Tech","Maryland",1,1,0.5,2
"4176","Georgia Tech","Miami FL",2,2,0.5,4
"4177","Georgia Tech","Mississippi",1,0,0,1
"4178","Georgia Tech","MS Valley St",0,1,1,1
"4179","Georgia Tech","NC A&T",0,1,1,1
"4180","Georgia Tech","NC State",4,0,0,4
"4181","Georgia Tech","North Carolina",5,0,0,5
"4182","Georgia Tech","Northwestern",0,1,1,1
"4183","Georgia Tech","Notre Dame",3,1,0.25,4
"4184","Georgia Tech","Pittsburgh",2,0,0,2
"4185","Georgia Tech","Presbyterian",0,2,1,2
"4186","Georgia Tech","Rhode Island",0,1,1,1
"4187","Georgia Tech","Rice",0,1,1,1
"4188","Georgia Tech","Rider",0,1,1,1
"4189","Georgia Tech","SC Upstate",1,0,0,1
"4190","Georgia Tech","St John's",1,0,0,1
"4191","Georgia Tech","St Mary's CA",0,1,1,1
"4192","Georgia Tech","Syracuse",1,1,0.5,2
"4193","Georgia Tech","Tulane",0,1,1,1
"4194","Georgia Tech","UNC Wilmington",0,1,1,1
"4195","Georgia Tech","Vanderbilt",1,1,0.5,2
"4196","Georgia Tech","Virginia",3,1,0.25,4
"4197","Georgia Tech","Virginia Tech",2,2,0.5,4
"4198","Georgia Tech","Wake Forest",1,4,0.8,5
"4199","Gonzaga","Arizona",1,0,0,1
"4200","Gonzaga","Arkansas",0,1,1,1
"4201","Gonzaga","Baylor",0,1,1,1
"4202","Gonzaga","Bryant",0,1,1,1
"4203","Gonzaga","Butler",1,0,0,1
"4204","Gonzaga","BYU",2,6,0.75,8
"4205","Gonzaga","Cal Poly SLO",0,1,1,1
"4206","Gonzaga","Campbell",0,1,1,1
"4207","Gonzaga","Clemson",0,1,1,1
"4208","Gonzaga","Colorado St",0,1,1,1
"4209","Gonzaga","Coppin St",0,1,1,1
"4210","Gonzaga","CS Sacramento",0,1,1,1
"4211","Gonzaga","Davidson",0,1,1,1
"4212","Gonzaga","Dayton",1,0,0,1
"4213","Gonzaga","Georgia",0,1,1,1
"4214","Gonzaga","Illinois",1,0,0,1
"4215","Gonzaga","Kansas St",1,1,0.5,2
"4216","Gonzaga","Loy Marymount",0,6,1,6
"4217","Gonzaga","Memphis",1,1,0.5,2
"4218","Gonzaga","New Mexico St",0,1,1,1
"4219","Gonzaga","Oakland",0,1,1,1
"4220","Gonzaga","Oklahoma",0,1,1,1
"4221","Gonzaga","Oklahoma St",0,1,1,1
"4222","Gonzaga","Pacific",0,5,1,5
"4223","Gonzaga","Pepperdine",0,7,1,7
"4224","Gonzaga","Portland",1,5,0.833333333333333,6
"4225","Gonzaga","San Diego",1,5,0.833333333333333,6
"4226","Gonzaga","San Francisco",0,7,1,7
"4227","Gonzaga","Santa Clara",0,7,1,7
"4228","Gonzaga","SE Louisiana",0,1,1,1
"4229","Gonzaga","SMU",0,1,1,1
"4230","Gonzaga","South Alabama",0,1,1,1
"4231","Gonzaga","South Dakota",0,1,1,1
"4232","Gonzaga","Southern Utah",0,1,1,1
"4233","Gonzaga","St John's",0,1,1,1
"4234","Gonzaga","St Joseph's PA",0,1,1,1
"4235","Gonzaga","St Mary's CA",0,7,1,7
"4236","Gonzaga","TX Southern",0,1,1,1
"4237","Gonzaga","UCLA",0,1,1,1
"4238","Gonzaga","Washington St",0,3,1,3
"4239","Gonzaga","West Virginia",0,2,1,2
"4240","Gonzaga","Chaminade",0,1,1,1
"4241","Gonzaga","Thomas Aquinas",0,1,1,1
"4242","Grambling","Air Force",1,0,0,1
"4243","Grambling","Alabama A&M",6,0,0,6
"4244","Grambling","Alabama St",6,0,0,6
"4245","Grambling","Alcorn St",6,1,0.142857142857143,7
"4246","Grambling","Arizona St",1,0,0,1
"4247","Grambling","Ark Little Rock",1,0,0,1
"4248","Grambling","Ark Pine Bluff",6,0,0,6
"4249","Grambling","Auburn",1,0,0,1
"4250","Grambling","Ball St",2,0,0,2
"4251","Grambling","Cleveland St",1,0,0,1
"4252","Grambling","DePaul",1,0,0,1
"4253","Grambling","Evansville",1,0,0,1
"4254","Grambling","G Washington",1,0,0,1
"4255","Grambling","Houston",1,0,0,1
"4256","Grambling","Jackson St",6,1,0.142857142857143,7
"4257","Grambling","Marquette",1,0,0,1
"4258","Grambling","Miami OH",1,0,0,1
"4259","Grambling","Missouri St",1,0,0,1
"4260","Grambling","MS Valley St",5,1,0.166666666666667,6
"4261","Grambling","Notre Dame",1,0,0,1
"4262","Grambling","Oregon St",2,0,0,2
"4263","Grambling","Prairie View",5,1,0.166666666666667,6
"4264","Grambling","Purdue",1,0,0,1
"4265","Grambling","SF Austin",1,0,0,1
"4266","Grambling","Southern Miss",1,0,0,1
"4267","Grambling","Southern Univ",6,0,0,6
"4268","Grambling","TCU",2,0,0,2
"4269","Grambling","Texas Tech",1,0,0,1
"4270","Grambling","TX Southern",7,0,0,7
"4271","Grambling","Washington",1,0,0,1
"4272","Grambling","Central Bap",0,1,1,1
"4273","Grambling","Lyon",1,1,0.5,2
"4274","Grambling","Selma AL",0,1,1,1
"4275","G Washington","Boston Univ",0,2,1,2
"4276","G Washington","Bradley",1,0,0,1
"4277","G Washington","Butler",1,0,0,1
"4278","G Washington","Charlotte",0,2,1,2
"4279","G Washington","Colorado",0,1,1,1
"4280","G Washington","Creighton",0,1,1,1
"4281","G Washington","Davidson",2,0,0,2
"4282","G Washington","Dayton",1,2,0.666666666666667,3
"4283","G Washington","Delaware St",0,1,1,1
"4284","G Washington","DePaul",0,1,1,1
"4285","G Washington","Duquesne",1,4,0.8,5
"4286","G Washington","Fordham",0,4,1,4
"4287","G Washington","George Mason",0,4,1,4
"4288","G Washington","Georgia",1,1,0.5,2
"4289","G Washington","Grambling",0,1,1,1
"4290","G Washington","Hofstra",0,2,1,2
"4291","G Washington","James Madison",0,1,1,1
"4292","G Washington","Kansas St",2,0,0,2
"4293","G Washington","La Salle",4,1,0.2,5
"4294","G Washington","Longwood",0,1,1,1
"4295","G Washington","Maine",0,1,1,1
"4296","G Washington","Manhattan",0,2,1,2
"4297","G Washington","Marquette",1,0,0,1
"4298","G Washington","Maryland",0,1,1,1
"4299","G Washington","Massachusetts",1,3,0.75,4
"4300","G Washington","Miami FL",0,1,1,1
"4301","G Washington","Mt St Mary's",1,0,0,1
"4302","G Washington","Notre Dame",1,0,0,1
"4303","G Washington","Ohio",0,1,1,1
"4304","G Washington","Penn St",1,0,0,1
"4305","G Washington","Radford",0,1,1,1
"4306","G Washington","Rhode Island",2,2,0.5,4
"4307","G Washington","Richmond",2,2,0.5,4
"4308","G Washington","Rutgers",1,2,0.666666666666667,3
"4309","G Washington","Sacred Heart",0,1,1,1
"4310","G Washington","Seton Hall",1,0,0,1
"4311","G Washington","St Bonaventure",0,3,1,3
"4312","G Washington","St Joseph's PA",1,2,0.666666666666667,3
"4313","G Washington","St Louis",2,1,0.333333333333333,3
"4314","G Washington","Temple",1,0,0,1
"4315","G Washington","VA Commonwealth",5,1,0.166666666666667,6
"4316","G Washington","Virginia",1,0,0,1
"4317","G Washington","VMI",0,2,1,2
"4318","G Washington","Wichita St",0,1,1,1
"4319","G Washington","Xavier",1,0,0,1
"4320","G Washington","Youngstown St",1,0,0,1
"4321","G Washington","UMBC",0,2,1,2
"4322","Hampton","Alcorn St",0,1,1,1
"4323","Hampton","American Univ",1,1,0.5,2
"4324","Hampton","Appalachian St",1,0,0,1
"4325","Hampton","Ark Pine Bluff",0,1,1,1
"4326","Hampton","Bethune-Cookman",0,3,1,3
"4327","Hampton","Coppin St",3,3,0.5,6
"4328","Hampton","Delaware",1,0,0,1
"4329","Hampton","Delaware St",2,4,0.666666666666667,6
"4330","Hampton","Florida A&M",0,3,1,3
"4331","Hampton","Howard",0,6,1,6
"4332","Hampton","Illinois",1,0,0,1
"4333","Hampton","Iowa",1,0,0,1
"4334","Hampton","James Madison",1,1,0.5,2
"4335","Hampton","Liberty",1,0,0,1
"4336","Hampton","MD E Shore",0,5,1,5
"4337","Hampton","Missouri St",1,0,0,1
"4338","Hampton","Morgan St",3,4,0.571428571428571,7
"4339","Hampton","NC A&T",1,1,0.5,2
"4340","Hampton","NC Central",3,0,0,3
"4341","Hampton","N Dakota St",1,0,0,1
"4342","Hampton","N Illinois",1,0,0,1
"4343","Hampton","NJIT",1,0,0,1
"4344","Hampton","N Kentucky",2,0,0,2
"4345","Hampton","Norfolk St",4,3,0.428571428571429,7
"4346","Hampton","Northern Arizona",0,1,1,1
"4347","Hampton","Ohio",1,0,0,1
"4348","Hampton","Quinnipiac",1,1,0.5,2
"4349","Hampton","Radford",1,1,0.5,2
"4350","Hampton","Richmond",1,0,0,1
"4351","Hampton","Robert Morris",1,0,0,1
"4352","Hampton","Savannah St",1,2,0.666666666666667,3
"4353","Hampton","S Carolina St",1,2,0.666666666666667,3
"4354","Hampton","SC Upstate",2,0,0,2
"4355","Hampton","St Peter's",1,1,0.5,2
"4356","Hampton","Syracuse",1,0,0,1
"4357","Hampton","Tennessee St",0,2,1,2
"4358","Hampton","UNC Wilmington",1,0,0,1
"4359","Hampton","Virginia",1,0,0,1
"4360","Hampton","William & Mary",1,1,0.5,2
"4361","Hampton","Winthrop",1,1,0.5,2
"4362","Hampton","Wofford",1,0,0,1
"4363","Hartford","Albany NY",5,1,0.166666666666667,6
"4364","Hartford","Arizona St",1,0,0,1
"4365","Hartford","Binghamton",0,7,1,7
"4366","Hartford","Boston Univ",0,2,1,2
"4367","Hartford","Central Conn",2,1,0.333333333333333,3
"4368","Hartford","Colorado",1,0,0,1
"4369","Hartford","Dartmouth",0,2,1,2
"4370","Hartford","Fairfield",0,1,1,1
"4371","Hartford","F Dickinson",0,2,1,2
"4372","Hartford","FL Gulf Coast",1,0,0,1
"4373","Hartford","Florida Intl",0,1,1,1
"4374","Hartford","Hofstra",1,0,0,1
"4375","Hartford","Holy Cross",1,3,0.75,4
"4376","Hartford","La Salle",2,0,0,2
"4377","Hartford","Louisville",1,0,0,1
"4378","Hartford","Maine",2,4,0.666666666666667,6
"4379","Hartford","Marist",0,1,1,1
"4380","Hartford","MD Baltimore Co",1,1,0.5,2
"4381","Hartford","Mt St Mary's",1,0,0,1
"4382","Hartford","New Hampshire",2,5,0.714285714285714,7
"4383","Hartford","Niagara",1,1,0.5,2
"4384","Hartford","Notre Dame",1,0,0,1
"4385","Hartford","Quinnipiac",2,1,0.333333333333333,3
"4386","Hartford","Rice",0,1,1,1
"4387","Hartford","Rider",1,0,0,1
"4388","Hartford","Sacred Heart",1,2,0.666666666666667,3
"4389","Hartford","Stony Brook",6,1,0.142857142857143,7
"4390","Hartford","St Peter's",0,2,1,2
"4391","Hartford","Texas A&M",1,0,0,1
"4392","Hartford","Vermont",5,1,0.166666666666667,6
"4393","Hartford","Washington",1,0,0,1
"4394","Hartford","Yale",2,1,0.333333333333333,3
"4395","Hartford","MA Lowell",1,3,0.75,4
"4396","Hartford","UMBC",1,3,0.75,4
"4397","Hartford","Emerson",0,1,1,1
"4398","Harvard","Arizona St",1,0,0,1
"4399","Harvard","Boston College",1,2,0.666666666666667,3
"4400","Harvard","Boston Univ",0,3,1,3
"4401","Harvard","Brown",0,6,1,6
"4402","Harvard","Bryant",0,2,1,2
"4403","Harvard","California",0,1,1,1
"4404","Harvard","Colorado",1,0,0,1
"4405","Harvard","Columbia",1,5,0.833333333333333,6
"4406","Harvard","Connecticut",2,0,0,2
"4407","Harvard","Cornell",1,5,0.833333333333333,6
"4408","Harvard","Dartmouth",1,5,0.833333333333333,6
"4409","Harvard","Denver",0,1,1,1
"4410","Harvard","FL Atlantic",1,1,0.5,2
"4411","Harvard","Fordham",0,2,1,2
"4412","Harvard","Holy Cross",1,2,0.666666666666667,3
"4413","Harvard","Houston",0,1,1,1
"4414","Harvard","Howard",0,1,1,1
"4415","Harvard","Manhattan",0,1,1,1
"4416","Harvard","Massachusetts",1,1,0.5,2
"4417","Harvard","Memphis",1,0,0,1
"4418","Harvard","Northeastern",0,2,1,2
"4419","Harvard","Penn",1,5,0.833333333333333,6
"4420","Harvard","Princeton",1,5,0.833333333333333,6
"4421","Harvard","Rice",0,2,1,2
"4422","Harvard","St Joseph's PA",1,0,0,1
"4423","Harvard","St Mary's CA",1,0,0,1
"4424","Harvard","TCU",0,1,1,1
"4425","Harvard","Vermont",1,2,0.666666666666667,3
"4426","Harvard","Virginia",1,0,0,1
"4427","Harvard","WI Green Bay",0,1,1,1
"4428","Harvard","Yale",2,5,0.714285714285714,7
"4429","Harvard","Grand Canyon",0,1,1,1
"4430","Harvard","MIT",0,2,1,2
"4431","Harvard","St Rose",0,1,1,1
"4432","Hawaii","Ark Pine Bluff",0,2,1,2
"4433","Hawaii","Boise St",1,0,0,1
"4434","Hawaii","BYU",1,0,0,1
"4435","Hawaii","Cal Poly SLO",4,2,0.333333333333333,6
"4436","Hawaii","Colorado",0,1,1,1
"4437","Hawaii","CS Bakersfield",0,1,1,1
"4438","Hawaii","CS Fullerton",0,6,1,6
"4439","Hawaii","CS Northridge",3,4,0.571428571428571,7
"4440","Hawaii","Delaware St",0,1,1,1
"4441","Hawaii","East Carolina",0,1,1,1
"4442","Hawaii","ETSU",0,1,1,1
"4443","Hawaii","High Point",1,0,0,1
"4444","Hawaii","Houston Bap",0,1,1,1
"4445","Hawaii","Illinois",1,0,0,1
"4446","Hawaii","Long Beach St",4,3,0.428571428571429,7
"4447","Hawaii","Marist",0,1,1,1
"4448","Hawaii","MD E Shore",0,1,1,1
"4449","Hawaii","Miami FL",1,0,0,1
"4450","Hawaii","Mississippi",1,0,0,1
"4451","Hawaii","Missouri",1,0,0,1
"4452","Hawaii","Montana",0,1,1,1
"4453","Hawaii","Nebraska",0,1,1,1
"4454","Hawaii","NE Omaha",0,1,1,1
"4455","Hawaii","New Mexico St",1,0,0,1
"4456","Hawaii","New Orleans",0,1,1,1
"4457","Hawaii","Norfolk St",0,1,1,1
"4458","Hawaii","North Dakota",0,1,1,1
"4459","Hawaii","Northern Arizona",0,2,1,2
"4460","Hawaii","Oregon St",0,1,1,1
"4461","Hawaii","Pacific",1,1,0.5,2
"4462","Hawaii","Pepperdine",1,0,0,1
"4463","Hawaii","Pittsburgh",0,1,1,1
"4464","Hawaii","Prairie View",0,1,1,1
"4465","Hawaii","San Francisco",1,0,0,1
"4466","Hawaii","Santa Barbara",4,2,0.333333333333333,6
"4467","Hawaii","Southern Univ",0,1,1,1
"4468","Hawaii","St Mary's CA",0,1,1,1
"4469","Hawaii","Tennessee St",0,1,1,1
"4470","Hawaii","UC Davis",3,4,0.571428571428571,7
"4471","Hawaii","UC Irvine",5,2,0.285714285714286,7
"4472","Hawaii","UC Riverside",1,5,0.833333333333333,6
"4473","Hawaii","UNLV",1,0,0,1
"4474","Hawaii","Wichita St",1,0,0,1
"4475","Hawaii","W Michigan",0,1,1,1
"4476","Hawaii","Chaminade",0,2,1,2
"4477","Hawaii","Hawaii Hilo",0,2,1,2
"4478","High Point","Appalachian St",0,1,1,1
"4479","High Point","Arkansas",1,0,0,1
"4480","High Point","Ark Pine Bluff",0,1,1,1
"4481","High Point","Austin Peay",0,1,1,1
"4482","High Point","Campbell",1,5,0.833333333333333,6
"4483","High Point","Charleston So",2,2,0.5,4
"4484","High Point","Chattanooga",1,0,0,1
"4485","High Point","Clemson",1,0,0,1
"4486","High Point","Coastal Car",2,2,0.5,4
"4487","High Point","CS Bakersfield",0,1,1,1
"4488","High Point","E Kentucky",2,0,0,2
"4489","High Point","Gardner Webb",2,3,0.6,5
"4490","High Point","Georgetown",1,0,0,1
"4491","High Point","Hawaii",0,1,1,1
"4492","High Point","Indiana St",1,0,0,1
"4493","High Point","James Madison",1,1,0.5,2
"4494","High Point","Liberty",0,5,1,5
"4495","High Point","Longwood",0,5,1,5
"4496","High Point","Morgan St",2,0,0,2
"4497","High Point","Ohio St",1,0,0,1
"4498","High Point","Presbyterian",0,4,1,4
"4499","High Point","Radford",5,1,0.166666666666667,6
"4500","High Point","Richmond",1,0,0,1
"4501","High Point","SF Austin",1,0,0,1
"4502","High Point","Syracuse",1,0,0,1
"4503","High Point","UNC Asheville",1,3,0.75,4
"4504","High Point","UNC Greensboro",1,2,0.666666666666667,3
"4505","High Point","VMI",1,3,0.75,4
"4506","High Point","Wake Forest",1,0,0,1
"4507","High Point","William & Mary",1,2,0.666666666666667,3
"4508","High Point","Winthrop",1,4,0.8,5
"4509","High Point","W Michigan",2,0,0,2
"4510","High Point","Wofford",1,1,0.5,2
"4511","High Point","Ferrum",0,2,1,2
"4512","High Point","Lee-McRae",0,1,1,1
"4513","High Point","Thomas GA",0,1,1,1
"4514","High Point","Peace",0,1,1,1
"4515","Hofstra","Appalachian St",0,1,1,1
"4516","Hofstra","Belmont",1,0,0,1
"4517","Hofstra","Central Conn",0,2,1,2
"4518","Hofstra","Col Charleston",1,3,0.75,4
"4519","Hofstra","Columbia",1,0,0,1
"4520","Hofstra","Coppin St",0,1,1,1
"4521","Hofstra","Delaware",5,2,0.285714285714286,7
"4522","Hofstra","Drexel",4,2,0.333333333333333,6
"4523","Hofstra","Elon",0,2,1,2
"4524","Hofstra","F Dickinson",1,1,0.5,2
"4525","Hofstra","FL Atlantic",1,0,0,1
"4526","Hofstra","George Mason",2,0,0,2
"4527","Hofstra","Georgia St",1,1,0.5,2
"4528","Hofstra","G Washington",2,0,0,2
"4529","Hofstra","Hartford",0,1,1,1
"4530","Hofstra","Jackson St",0,1,1,1
"4531","Hofstra","Jacksonville",0,1,1,1
"4532","Hofstra","James Madison",4,2,0.333333333333333,6
"4533","Hofstra","La Salle",1,0,0,1
"4534","Hofstra","Long Island",1,1,0.5,2
"4535","Hofstra","Louisville",1,0,0,1
"4536","Hofstra","Manhattan",2,0,0,2
"4537","Hofstra","Marshall",0,1,1,1
"4538","Hofstra","Monmouth NJ",2,0,0,2
"4539","Hofstra","NC State",1,0,0,1
"4540","Hofstra","NJIT",0,1,1,1
"4541","Hofstra","Norfolk St",0,1,1,1
"4542","Hofstra","Northeastern",6,0,0,6
"4543","Hofstra","Old Dominion",0,1,1,1
"4544","Hofstra","Purdue",1,0,0,1
"4545","Hofstra","Richmond",1,0,0,1
"4546","Hofstra","Sacred Heart",1,0,0,1
"4547","Hofstra","S Dakota St",0,1,1,1
"4548","Hofstra","Siena",1,0,0,1
"4549","Hofstra","SMU",2,0,0,2
"4550","Hofstra","South Florida",1,0,0,1
"4551","Hofstra","Stony Brook",0,1,1,1
"4552","Hofstra","Towson",5,1,0.166666666666667,6
"4553","Hofstra","Tulane",2,0,0,2
"4554","Hofstra","UNC Wilmington",2,5,0.714285714285714,7
"4555","Hofstra","Wagner",1,1,0.5,2
"4556","Hofstra","William & Mary",5,2,0.285714285714286,7
"4557","Hofstra","Wright St",1,0,0,1
"4558","Holy Cross","Albany NY",0,2,1,2
"4559","Holy Cross","American Univ",6,1,0.142857142857143,7
"4560","Holy Cross","Army",3,3,0.5,6
"4561","Holy Cross","Belmont",1,0,0,1
"4562","Holy Cross","Boston College",1,0,0,1
"4563","Holy Cross","Boston Univ",3,1,0.25,4
"4564","Holy Cross","Brown",0,1,1,1
"4565","Holy Cross","Bucknell",5,2,0.285714285714286,7
"4566","Holy Cross","Canisius",2,0,0,2
"4567","Holy Cross","Colgate",2,4,0.666666666666667,6
"4568","Holy Cross","Columbia",0,1,1,1
"4569","Holy Cross","Dartmouth",0,1,1,1
"4570","Holy Cross","Fairfield",0,1,1,1
"4571","Holy Cross","Hartford",3,1,0.25,4
"4572","Holy Cross","Harvard",2,1,0.333333333333333,3
"4573","Holy Cross","Lafayette",5,2,0.285714285714286,7
"4574","Holy Cross","Lehigh",3,4,0.571428571428571,7
"4575","Holy Cross","Loyola MD",1,4,0.8,5
"4576","Holy Cross","Maine",0,1,1,1
"4577","Holy Cross","Michigan",1,0,0,1
"4578","Holy Cross","Morgan St",0,1,1,1
"4579","Holy Cross","Navy",1,5,0.833333333333333,6
"4580","Holy Cross","New Hampshire",0,2,1,2
"4581","Holy Cross","NJIT",0,2,1,2
"4582","Holy Cross","North Carolina",1,0,0,1
"4583","Holy Cross","Old Dominion",0,1,1,1
"4584","Holy Cross","Pittsburgh",1,0,0,1
"4585","Holy Cross","Providence",1,0,0,1
"4586","Holy Cross","Sacred Heart",1,2,0.666666666666667,3
"4587","Holy Cross","San Francisco",0,1,1,1
"4588","Holy Cross","St John's",1,0,0,1
"4589","Holy Cross","Syracuse",1,0,0,1
"4590","Holy Cross","UT San Antonio",1,0,0,1
"4591","Holy Cross","Yale",1,0,0,1
"4592","Holy Cross","Nichols",0,1,1,1
"4593","Houston","Alcorn St",0,1,1,1
"4594","Houston","Ark Pine Bluff",1,0,0,1
"4595","Houston","Boise St",1,0,0,1
"4596","Houston","Chicago St",0,1,1,1
"4597","Houston","Cincinnati",4,0,0,4
"4598","Houston","Connecticut",1,2,0.666666666666667,3
"4599","Houston","East Carolina",2,1,0.333333333333333,3
"4600","Houston","Florida A&M",0,1,1,1
"4601","Houston","Grambling",0,1,1,1
"4602","Houston","Harvard",1,0,0,1
"4603","Houston","Houston Bap",0,1,1,1
"4604","Houston","Howard",0,1,1,1
"4605","Houston","Lehigh",0,1,1,1
"4606","Houston","Louisville",3,0,0,3
"4607","Houston","Marshall",0,1,1,1
"4608","Houston","Memphis",4,1,0.2,5
"4609","Houston","Morgan St",0,1,1,1
"4610","Houston","MS Valley St",0,1,1,1
"4611","Houston","Murray St",0,1,1,1
"4612","Houston","Prairie View",1,1,0.5,2
"4613","Houston","Rice",1,3,0.75,4
"4614","Houston","Rutgers",1,1,0.5,2
"4615","Houston","San Jose St",1,1,0.5,2
"4616","Houston","S Carolina St",1,0,0,1
"4617","Houston","SMU",4,3,0.428571428571429,7
"4618","Houston","Southern Miss",1,0,0,1
"4619","Houston","South Florida",1,3,0.75,4
"4620","Houston","Stanford",1,0,0,1
"4621","Houston","TAM C. Christi",0,2,1,2
"4622","Houston","TCU",0,1,1,1
"4623","Houston","Temple",1,2,0.666666666666667,3
"4624","Houston","Texas A&M",2,0,0,2
"4625","Houston","Texas St",0,1,1,1
"4626","Houston","Texas Tech",1,1,0.5,2
"4627","Houston","Tulane",2,3,0.6,5
"4628","Houston","Tulsa",5,0,0,5
"4629","Houston","TX Pan American",0,3,1,3
"4630","Houston","TX Southern",0,1,1,1
"4631","Houston","UAB",0,1,1,1
"4632","Houston","UCF",4,1,0.2,5
"4633","Houston","ULL",1,1,0.5,2
"4634","Houston","UTEP",1,1,0.5,2
"4635","Houston","UT San Antonio",0,1,1,1
"4636","Houston","Abilene Chr",0,1,1,1
"4637","Houston Bap","Ark Pine Bluff",0,1,1,1
"4638","Houston Bap","Army",1,1,0.5,2
"4639","Houston Bap","Cent Arkansas",1,2,0.666666666666667,3
"4640","Houston Bap","Chicago St",2,0,0,2
"4641","Houston Bap","DePaul",1,0,0,1
"4642","Houston Bap","E Illinois",1,0,0,1
"4643","Houston Bap","Hawaii",1,0,0,1
"4644","Houston Bap","Houston",1,0,0,1
"4645","Houston Bap","Lamar",2,1,0.333333333333333,3
"4646","Houston Bap","LSU",1,0,0,1
"4647","Houston Bap","McNeese St",2,1,0.333333333333333,3
"4648","Houston Bap","MD E Shore",0,1,1,1
"4649","Houston Bap","Michigan",1,0,0,1
"4650","Houston Bap","Missouri KC",0,2,1,2
"4651","Houston Bap","New Orleans",1,3,0.75,4
"4652","Houston Bap","Nicholls St",3,0,0,3
"4653","Houston Bap","NJIT",1,1,0.5,2
"4654","Houston Bap","Northwestern",1,0,0,1
"4655","Houston Bap","Northwestern LA",1,1,0.5,2
"4656","Houston Bap","Oral Roberts",2,0,0,2
"4657","Houston Bap","Oregon",1,0,0,1
"4658","Houston Bap","Pepperdine",2,0,0,2
"4659","Houston Bap","Rice",1,2,0.666666666666667,3
"4660","Houston Bap","Sam Houston St",4,0,0,4
"4661","Houston Bap","San Francisco",1,0,0,1
"4662","Houston Bap","SE Louisiana",2,0,0,2
"4663","Houston Bap","SF Austin",3,0,0,3
"4664","Houston Bap","South Alabama",1,0,0,1
"4665","Houston Bap","Southern Miss",1,0,0,1
"4666","Houston Bap","TAM C. Christi",3,1,0.25,4
"4667","Houston Bap","Texas",1,0,0,1
"4668","Houston Bap","Texas A&M",1,0,0,1
"4669","Houston Bap","Texas Tech",1,0,0,1
"4670","Houston Bap","TX Pan American",1,1,0.5,2
"4671","Houston Bap","UC Riverside",1,0,0,1
"4672","Houston Bap","Utah Valley",1,1,0.5,2
"4673","Houston Bap","UT Arlington",3,0,0,3
"4674","Houston Bap","UTEP",1,0,0,1
"4675","Houston Bap","Wright St",1,0,0,1
"4676","Houston Bap","Abilene Chr",2,1,0.333333333333333,3
"4677","Houston Bap","Arlington Bap",0,2,1,2
"4678","Houston Bap","Crowley's Ridge",0,1,1,1
"4679","Houston Bap","Dallas Chr",0,1,1,1
"4680","Houston Bap","Ecclesia",0,1,1,1
"4681","Houston Bap","Hillsdale Bap",0,1,1,1
"4682","Houston Bap","Incarnate Word",2,1,0.333333333333333,3
"4683","Howard","American Univ",1,1,0.5,2
"4684","Howard","Bethune-Cookman",2,1,0.333333333333333,3
"4685","Howard","Boston Univ",1,0,0,1
"4686","Howard","Col Charleston",1,0,0,1
"4687","Howard","Coppin St",2,3,0.6,5
"4688","Howard","Cornell",1,0,0,1
"4689","Howard","Delaware St",4,2,0.333333333333333,6
"4690","Howard","Duquesne",1,0,0,1
"4691","Howard","Florida A&M",1,2,0.666666666666667,3
"4692","Howard","Fordham",2,0,0,2
"4693","Howard","Gardner Webb",1,0,0,1
"4694","Howard","Hampton",6,0,0,6
"4695","Howard","Harvard",1,0,0,1
"4696","Howard","Houston",1,0,0,1
"4697","Howard","Iowa",1,0,0,1
"4698","Howard","IUPUI",0,1,1,1
"4699","Howard","Liberty",1,1,0.5,2
"4700","Howard","MD E Shore",2,4,0.666666666666667,6
"4701","Howard","Miami FL",1,0,0,1
"4702","Howard","Morgan St",3,1,0.25,4
"4703","Howard","NC A&T",1,3,0.75,4
"4704","Howard","NC Central",4,0,0,4
"4705","Howard","NJIT",1,0,0,1
"4706","Howard","Norfolk St",4,1,0.2,5
"4707","Howard","Old Dominion",1,0,0,1
"4708","Howard","Oregon St",1,0,0,1
"4709","Howard","Pepperdine",1,0,0,1
"4710","Howard","Pittsburgh",2,0,0,2
"4711","Howard","Radford",1,0,0,1
"4712","Howard","Richmond",1,0,0,1
"4713","Howard","Rutgers",1,0,0,1
"4714","Howard","Savannah St",2,1,0.333333333333333,3
"4715","Howard","S Carolina St",0,2,1,2
"4716","Howard","S Dakota St",1,0,0,1
"4717","Howard","South Alabama",0,1,1,1
"4718","Howard","TX Southern",1,0,0,1
"4719","Howard","UCF",2,0,0,2
"4720","Howard","USC",1,0,0,1
"4721","Howard","W Carolina",1,0,0,1
"4722","Howard","Wichita St",1,0,0,1
"4723","Howard","William & Mary",3,0,0,3
"4724","Howard","Goucher",0,1,1,1
"4725","Howard","Gwynedd-Mercy",0,2,1,2
"4726","Howard","UMBC",0,1,1,1
"4727","Howard","Washington MD",0,1,1,1
"4728","Howard","Hood",0,1,1,1
"4729","Idaho","Boise St",3,0,0,3
"4730","Idaho","Chicago St",1,1,0.5,2
"4731","Idaho","Columbia",1,0,0,1
"4732","Idaho","CS Bakersfield",1,1,0.5,2
"4733","Idaho","CS Northridge",1,1,0.5,2
"4734","Idaho","CS Sacramento",1,1,0.5,2
"4735","Idaho","Denver",2,0,0,2
"4736","Idaho","E Washington",3,1,0.25,4
"4737","Idaho","Idaho St",1,3,0.75,4
"4738","Idaho","Louisiana Tech",2,0,0,2
"4739","Idaho","Missouri KC",1,2,0.666666666666667,3
"4740","Idaho","Montana",4,1,0.2,5
"4741","Idaho","Montana St",0,2,1,2
"4742","Idaho","N Colorado",0,1,1,1
"4743","Idaho","New Mexico",1,0,0,1
"4744","Idaho","New Mexico St",4,1,0.2,5
"4745","Idaho","N Illinois",1,0,0,1
"4746","Idaho","N Kentucky",2,0,0,2
"4747","Idaho","North Dakota",1,0,0,1
"4748","Idaho","Northern Arizona",1,0,0,1
"4749","Idaho","North Texas",0,1,1,1
"4750","Idaho","Oklahoma",1,0,0,1
"4751","Idaho","Portland",1,0,0,1
"4752","Idaho","Portland St",1,2,0.666666666666667,3
"4753","Idaho","San Jose St",0,2,1,2
"4754","Idaho","S Dakota St",1,1,0.5,2
"4755","Idaho","Seattle",2,2,0.5,4
"4756","Idaho","Southern Utah",1,0,0,1
"4757","Idaho","Texas St",1,1,0.5,2
"4758","Idaho","TX Pan American",0,2,1,2
"4759","Idaho","UC Davis",0,3,1,3
"4760","Idaho","Utah St",2,0,0,2
"4761","Idaho","Utah Valley",2,1,0.333333333333333,3
"4762","Idaho","UT Arlington",1,1,0.5,2
"4763","Idaho","UTEP",1,0,0,1
"4764","Idaho","UT San Antonio",1,1,0.5,2
"4765","Idaho","Washington St",2,1,0.333333333333333,3
"4766","Idaho","Weber St",1,1,0.5,2
"4767","Idaho","WI Green Bay",0,1,1,1
"4768","Idaho","W Illinois",1,1,0.5,2
"4769","Idaho","Wright St",1,0,0,1
"4770","Idaho","Grand Canyon",1,1,0.5,2
"4771","Idaho","NW Nazarene",0,1,1,1
"4772","Idaho","Walla Walla",0,1,1,1
"4773","Idaho","Eastern Oregon",0,1,1,1
"4774","Idaho St","Arizona St",1,0,0,1
"4775","Idaho St","C Michigan",1,0,0,1
"4776","Idaho St","CS Bakersfield",3,0,0,3
"4777","Idaho St","CS Fullerton",1,0,0,1
"4778","Idaho St","CS Sacramento",3,2,0.4,5
"4779","Idaho St","Denver",1,0,0,1
"4780","Idaho St","E Washington",5,1,0.166666666666667,6
"4781","Idaho St","Idaho",3,1,0.25,4
"4782","Idaho St","Montana",6,0,0,6
"4783","Idaho St","Montana St",3,3,0.5,6
"4784","Idaho St","N Colorado",3,2,0.4,5
"4785","Idaho St","New Mexico",1,0,0,1
"4786","Idaho St","North Dakota",5,0,0,5
"4787","Idaho St","Northern Arizona",5,1,0.166666666666667,6
"4788","Idaho St","Oregon",1,0,0,1
"4789","Idaho St","Pacific",1,0,0,1
"4790","Idaho St","Portland",1,0,0,1
"4791","Idaho St","Portland St",2,3,0.6,5
"4792","Idaho St","San Francisco",0,1,1,1
"4793","Idaho St","S Dakota St",1,0,0,1
"4794","Idaho St","Southern Utah",3,3,0.5,6
"4795","Idaho St","Utah",2,0,0,2
"4796","Idaho St","Utah St",2,0,0,2
"4797","Idaho St","Utah Valley",2,0,0,2
"4798","Idaho St","Washington",1,0,0,1
"4799","Idaho St","Washington St",2,0,0,2
"4800","Idaho St","Weber St",5,1,0.166666666666667,6
"4801","Idaho St","Wright St",1,0,0,1
"4802","Idaho St","Carroll MT",0,1,1,1
"4803","Idaho St","Evergreen St",0,1,1,1
"4804","Idaho St","Grand Canyon",0,1,1,1
"4805","Idaho St","MT Western",0,1,1,1
"4806","Idaho St","NW Nazarene",0,1,1,1
"4807","IL Chicago","Bradley",2,0,0,2
"4808","IL Chicago","Cleveland St",6,1,0.142857142857143,7
"4809","IL Chicago","Colorado St",1,1,0.5,2
"4810","IL Chicago","Dayton",1,0,0,1
"4811","IL Chicago","DePaul",1,0,0,1
"4812","IL Chicago","Detroit",5,1,0.166666666666667,6
"4813","IL Chicago","Drake",1,0,0,1
"4814","IL Chicago","E Illinois",1,0,0,1
"4815","IL Chicago","E Michigan",0,1,1,1
"4816","IL Chicago","Illinois",1,0,0,1
"4817","IL Chicago","Iona",0,1,1,1
"4818","IL Chicago","Kent",1,0,0,1
"4819","IL Chicago","Louisiana Tech",1,0,0,1
"4820","IL Chicago","Loyola-Chicago",3,1,0.25,4
"4821","IL Chicago","Mercer",0,1,1,1
"4822","IL Chicago","Miami OH",1,0,0,1
"4823","IL Chicago","New Mexico",1,0,0,1
"4824","IL Chicago","N Illinois",0,1,1,1
"4825","IL Chicago","Northwestern",2,1,0.333333333333333,3
"4826","IL Chicago","Oakland",4,1,0.2,5
"4827","IL Chicago","San Diego",0,1,1,1
"4828","IL Chicago","SE Missouri St",0,2,1,2
"4829","IL Chicago","S Illinois",1,0,0,1
"4830","IL Chicago","SMU",2,0,0,2
"4831","IL Chicago","TN Martin",1,0,0,1
"4832","IL Chicago","Toledo",1,0,0,1
"4833","IL Chicago","UCF",0,1,1,1
"4834","IL Chicago","UC Riverside",1,1,0.5,2
"4835","IL Chicago","Valparaiso",7,0,0,7
"4836","IL Chicago","Wagner",0,1,1,1
"4837","IL Chicago","WI Green Bay",6,1,0.142857142857143,7
"4838","IL Chicago","W Illinois",1,1,0.5,2
"4839","IL Chicago","WI Milwaukee",4,2,0.333333333333333,6
"4840","IL Chicago","Wright St",2,5,0.714285714285714,7
"4841","IL Chicago","Yale",1,0,0,1
"4842","IL Chicago","Youngstown St",3,3,0.5,6
"4843","IL Chicago","Grand Canyon",1,0,0,1
"4844","IL Chicago","Judson IL",0,1,1,1
"4845","IL Chicago","Purdue Calumet",0,1,1,1
"4846","IL Chicago","Roosevelt",0,1,1,1
"4847","IL Chicago","St Xavier IL",0,1,1,1
"4848","Illinois","Alabama St",0,1,1,1
"4849","Illinois","American Univ",0,1,1,1
"4850","Illinois","Auburn",0,2,1,2
"4851","Illinois","Austin Peay",0,1,1,1
"4852","Illinois","Baylor",0,1,1,1
"4853","Illinois","Bradley",0,1,1,1
"4854","Illinois","Brown",0,1,1,1
"4855","Illinois","Butler",0,1,1,1
"4856","Illinois","Chicago St",0,1,1,1
"4857","Illinois","Colgate",0,1,1,1
"4858","Illinois","Coppin St",0,1,1,1
"4859","Illinois","Dartmouth",0,1,1,1
"4860","Illinois","E Kentucky",0,1,1,1
"4861","Illinois","Gardner Webb",0,1,1,1
"4862","Illinois","Ga Southern",0,1,1,1
"4863","Illinois","Georgia Tech",1,1,0.5,2
"4864","Illinois","Gonzaga",0,1,1,1
"4865","Illinois","Hampton",0,1,1,1
"4866","Illinois","Hawaii",0,1,1,1
"4867","Illinois","IL Chicago",0,1,1,1
"4868","Illinois","Indiana",2,3,0.6,5
"4869","Illinois","Indiana St",0,1,1,1
"4870","Illinois","Iowa",3,1,0.25,4
"4871","Illinois","IPFW",0,1,1,1
"4872","Illinois","Jacksonville St",0,1,1,1
"4873","Illinois","Kennesaw",0,1,1,1
"4874","Illinois","Maryland",0,1,1,1
"4875","Illinois","Miami FL",1,0,0,1
"4876","Illinois","Michigan",6,1,0.142857142857143,7
"4877","Illinois","Michigan St",3,2,0.4,5
"4878","Illinois","Minnesota",2,2,0.5,4
"4879","Illinois","Missouri",1,2,0.666666666666667,3
"4880","Illinois","Nebraska",2,4,0.666666666666667,6
"4881","Illinois","Norfolk St",0,1,1,1
"4882","Illinois","Northwestern",2,3,0.6,5
"4883","Illinois","Ohio St",4,1,0.2,5
"4884","Illinois","Oregon",2,0,0,2
"4885","Illinois","Penn St",0,4,1,4
"4886","Illinois","Purdue",3,2,0.4,5
"4887","Illinois","Rutgers",0,1,1,1
"4888","Illinois","St Francis NY",0,1,1,1
"4889","Illinois","UNLV",0,1,1,1
"4890","Illinois","USC",0,1,1,1
"4891","Illinois","Valparaiso",0,1,1,1
"4892","Illinois","Villanova",1,0,0,1
"4893","Illinois","W Carolina",0,1,1,1
"4894","Illinois","Wisconsin",5,0,0,5
"4895","Illinois St","Austin Peay",0,1,1,1
"4896","Illinois St","Bradley",2,4,0.666666666666667,6
"4897","Illinois St","Chicago St",0,1,1,1
"4898","Illinois St","Creighton",1,1,0.5,2
"4899","Illinois St","Dayton",0,2,1,2
"4900","Illinois St","Delaware St",0,1,1,1
"4901","Illinois St","DePaul",0,2,1,2
"4902","Illinois St","Drake",1,5,0.833333333333333,6
"4903","Illinois St","Drexel",1,1,0.5,2
"4904","Illinois St","Evansville",2,5,0.714285714285714,7
"4905","Illinois St","F Dickinson",0,1,1,1
"4906","Illinois St","Indiana St",4,2,0.333333333333333,6
"4907","Illinois St","IPFW",0,1,1,1
"4908","Illinois St","Louisville",1,0,0,1
"4909","Illinois St","Loyola-Chicago",1,3,0.75,4
"4910","Illinois St","Manhattan",1,0,0,1
"4911","Illinois St","Missouri St",3,4,0.571428571428571,7
"4912","Illinois St","Morgan St",0,1,1,1
"4913","Illinois St","Murray St",1,0,0,1
"4914","Illinois St","Northern Iowa",6,1,0.142857142857143,7
"4915","Illinois St","Northwestern",1,1,0.5,2
"4916","Illinois St","Oakland",1,0,0,1
"4917","Illinois St","Old Dominion",0,1,1,1
"4918","Illinois St","San Francisco",0,1,1,1
"4919","Illinois St","Santa Barbara",0,1,1,1
"4920","Illinois St","Seton Hall",1,0,0,1
"4921","Illinois St","S Illinois",2,4,0.666666666666667,6
"4922","Illinois St","Tennessee St",0,1,1,1
"4923","Illinois St","TN Martin",0,1,1,1
"4924","Illinois St","UAB",0,2,1,2
"4925","Illinois St","Utah St",2,0,0,2
"4926","Illinois St","VA Commonwealth",2,0,0,2
"4927","Illinois St","Vermont",1,0,0,1
"4928","Illinois St","Weber St",0,1,1,1
"4929","Illinois St","Wichita St",6,1,0.142857142857143,7
"4930","Illinois St","W Michigan",0,1,1,1
"4931","Illinois St","Wyoming",1,0,0,1
"4932","Illinois St","Youngstown St",0,1,1,1
"4933","Illinois St","Sonoma St",0,1,1,1
"4934","Illinois St","Quincy",0,1,1,1
"4935","Indiana","Ball St",0,1,1,1
"4936","Indiana","Bryant",0,1,1,1
"4937","Indiana","Butler",1,1,0.5,2
"4938","Indiana","Central Conn",0,1,1,1
"4939","Indiana","Chicago St",0,1,1,1
"4940","Indiana","Connecticut",1,0,0,1
"4941","Indiana","Coppin St",0,1,1,1
"4942","Indiana","Evansville",0,1,1,1
"4943","Indiana","E Washington",1,0,0,1
"4944","Indiana","FL Atlantic",0,1,1,1
"4945","Indiana","Georgetown",1,1,0.5,2
"4946","Indiana","Georgia",0,1,1,1
"4947","Indiana","Illinois",3,2,0.4,5
"4948","Indiana","Iowa",1,3,0.75,4
"4949","Indiana","Jacksonville",0,1,1,1
"4950","Indiana","Kennesaw",0,1,1,1
"4951","Indiana","Lamar",0,1,1,1
"4952","Indiana","Long Island",0,1,1,1
"4953","Indiana","Louisville",1,0,0,1
"4954","Indiana","Maryland",2,1,0.333333333333333,3
"4955","Indiana","Michigan",1,4,0.8,5
"4956","Indiana","Michigan St",4,2,0.333333333333333,6
"4957","Indiana","Minnesota",2,2,0.5,4
"4958","Indiana","MS Valley St",0,1,1,1
"4959","Indiana","Mt St Mary's",0,1,1,1
"4960","Indiana","N Dakota St",0,1,1,1
"4961","Indiana","Nebraska",2,2,0.5,4
"4962","Indiana","New Orleans",0,1,1,1
"4963","Indiana","Nicholls St",0,1,1,1
"4964","Indiana","North Carolina",0,1,1,1
"4965","Indiana","North Florida",0,1,1,1
"4966","Indiana","Northwestern",2,3,0.6,5
"4967","Indiana","Notre Dame",1,0,0,1
"4968","Indiana","Oakland",0,1,1,1
"4969","Indiana","Ohio St",2,3,0.6,5
"4970","Indiana","Penn St",1,4,0.8,5
"4971","Indiana","Pittsburgh",0,1,1,1
"4972","Indiana","Purdue",3,2,0.4,5
"4973","Indiana","Rutgers",0,2,1,2
"4974","Indiana","Samford",0,1,1,1
"4975","Indiana","Sam Houston St",0,1,1,1
"4976","Indiana","Savannah St",0,1,1,1
"4977","Indiana","SMU",0,1,1,1
"4978","Indiana","Stony Brook",0,1,1,1
"4979","Indiana","Syracuse",1,0,0,1
"4980","Indiana","TX Southern",0,1,1,1
"4981","Indiana","UNC Greensboro",0,1,1,1
"4982","Indiana","Washington",0,1,1,1
"4983","Indiana","Wisconsin",3,1,0.25,4
"4984","Indiana","Grand Canyon",0,1,1,1
"4985","Indiana St","Austin Peay",0,1,1,1
"4986","Indiana St","Ball St",1,2,0.666666666666667,3
"4987","Indiana St","Belmont",1,1,0.5,2
"4988","Indiana St","Bradley",1,5,0.833333333333333,6
"4989","Indiana St","Brown",0,1,1,1
"4990","Indiana St","Butler",1,0,0,1
"4991","Indiana St","Creighton",1,1,0.5,2
"4992","Indiana St","Drake",3,3,0.5,6
"4993","Indiana St","E Illinois",1,1,0.5,2
"4994","Indiana St","Evansville",2,4,0.666666666666667,6
"4995","Indiana St","High Point",0,1,1,1
"4996","Indiana St","Illinois",1,0,0,1
"4997","Indiana St","Illinois St",2,4,0.666666666666667,6
"4998","Indiana St","Iona",1,1,0.5,2
"4999","Indiana St","IUPUI",0,3,1,3
"5000","Indiana St","Loyola-Chicago",1,5,0.833333333333333,6
"5001","Indiana St","Memphis",1,0,0,1
"5002","Indiana St","Miami FL",0,1,1,1
"5003","Indiana St","Mississippi",0,1,1,1
"5004","Indiana St","Missouri KC",1,1,0.5,2
"5005","Indiana St","Missouri St",3,3,0.5,6
"5006","Indiana St","Morehead St",1,0,0,1
"5007","Indiana St","New Mexico",1,0,0,1
"5008","Indiana St","Northern Iowa",3,3,0.5,6
"5009","Indiana St","Notre Dame",0,1,1,1
"5010","Indiana St","Pepperdine",0,1,1,1
"5011","Indiana St","San Diego St",1,0,0,1
"5012","Indiana St","S Illinois",2,5,0.714285714285714,7
"5013","Indiana St","St Louis",2,0,0,2
"5014","Indiana St","Tulsa",1,0,0,1
"5015","Indiana St","UCLA",1,0,0,1
"5016","Indiana St","Wichita St",6,1,0.142857142857143,7
"5017","Indiana St","Winthrop",0,1,1,1
"5018","Indiana St","AK Anchorage",0,1,1,1
"5019","Indiana St","Truman St",0,2,1,2
"5020","Iona","Arkansas",1,0,0,1
"5021","Iona","Canisius",3,4,0.571428571428571,7
"5022","Iona","Cleveland St",1,1,0.5,2
"5023","Iona","Dayton",1,0,0,1
"5024","Iona","Delaware St",0,1,1,1
"5025","Iona","Denver",0,1,1,1
"5026","Iona","Drexel",0,1,1,1
"5027","Iona","Fairfield",1,5,0.833333333333333,6
"5028","Iona","FL Gulf Coast",0,2,1,2
"5029","Iona","George Mason",1,1,0.5,2
"5030","Iona","Georgia",0,1,1,1
"5031","Iona","IL Chicago",1,0,0,1
"5032","Iona","Indiana St",1,1,0.5,2
"5033","Iona","Kansas",1,0,0,1
"5034","Iona","La Salle",1,0,0,1
"5035","Iona","Liberty",0,1,1,1
"5036","Iona","Loyola MD",0,2,1,2
"5037","Iona","Manhattan",4,4,0.5,8
"5038","Iona","Marist",1,5,0.833333333333333,6
"5039","Iona","Massachusetts",1,0,0,1
"5040","Iona","Monmouth NJ",1,4,0.8,5
"5041","Iona","Nevada",1,0,0,1
"5042","Iona","Niagara",1,5,0.833333333333333,6
"5043","Iona","Norfolk St",0,1,1,1
"5044","Iona","Northern Iowa",1,0,0,1
"5045","Iona","North Texas",0,1,1,1
"5046","Iona","Quinnipiac",2,3,0.6,5
"5047","Iona","Rider",1,6,0.857142857142857,7
"5048","Iona","Rutgers",1,0,0,1
"5049","Iona","Siena",0,7,1,7
"5050","Iona","St Bonaventure",1,1,0.5,2
"5051","Iona","St Joseph's PA",1,0,0,1
"5052","Iona","St Peter's",2,4,0.666666666666667,6
"5053","Iona","Wake Forest",0,2,1,2
"5054","Iona","Wofford",1,1,0.5,2
"5055","Iowa","Alcorn St",0,1,1,1
"5056","Iowa","Ark Pine Bluff",0,1,1,1
"5057","Iowa","C Michigan",0,1,1,1
"5058","Iowa","Coppin St",0,1,1,1
"5059","Iowa","Drake",0,1,1,1
"5060","Iowa","F Dickinson",0,1,1,1
"5061","Iowa","Gardner Webb",0,1,1,1
"5062","Iowa","Hampton",0,1,1,1
"5063","Iowa","Howard",0,1,1,1
"5064","Iowa","Illinois",1,3,0.75,4
"5065","Iowa","Indiana",3,1,0.25,4
"5066","Iowa","Iowa St",2,1,0.333333333333333,3
"5067","Iowa","Longwood",0,1,1,1
"5068","Iowa","Maryland",0,1,1,1
"5069","Iowa","MD E Shore",0,1,1,1
"5070","Iowa","Michigan",2,2,0.5,4
"5071","Iowa","Michigan St",4,0,0,4
"5072","Iowa","Minnesota",3,3,0.5,6
"5073","Iowa","N Dakota St",0,1,1,1
"5074","Iowa","Nebraska",1,4,0.8,5
"5075","Iowa","NE Omaha",0,1,1,1
"5076","Iowa","N Illinois",0,1,1,1
"5077","Iowa","North Carolina",0,1,1,1
"5078","Iowa","Northern Iowa",1,1,0.5,2
"5079","Iowa","North Florida",0,1,1,1
"5080","Iowa","Northwestern",2,5,0.714285714285714,7
"5081","Iowa","Notre Dame",0,1,1,1
"5082","Iowa","Ohio St",2,3,0.6,5
"5083","Iowa","Penn",0,1,1,1
"5084","Iowa","Penn St",1,4,0.8,5
"5085","Iowa","Pepperdine",0,1,1,1
"5086","Iowa","Purdue",2,2,0.5,4
"5087","Iowa","Rutgers",0,1,1,1
"5088","Iowa","S Carolina St",0,1,1,1
"5089","Iowa","South Dakota",0,1,1,1
"5090","Iowa","Syracuse",1,0,0,1
"5091","Iowa","TAM C. Christi",0,1,1,1
"5092","Iowa","Texas",1,0,0,1
"5093","Iowa","TX Pan American",0,1,1,1
"5094","Iowa","UNC Wilmington",0,1,1,1
"5095","Iowa","UTEP",0,1,1,1
"5096","Iowa","Villanova",1,0,0,1
"5097","Iowa","Virginia Tech",1,0,0,1
"5098","Iowa","Wichita St",1,0,0,1
"5099","Iowa","Wisconsin",5,1,0.166666666666667,6
"5100","Iowa","W Kentucky",0,1,1,1
"5101","Iowa","Xavier",0,1,1,1
"5102","Iowa","Abilene Chr",0,1,1,1
"5103","Iowa","UMBC",0,1,1,1
"5104","Iowa St","Akron",0,1,1,1
"5105","Iowa St","Alabama",0,1,1,1
"5106","Iowa St","Alabama A&M",0,1,1,1
"5107","Iowa St","Arkansas",0,1,1,1
"5108","Iowa St","Auburn",0,1,1,1
"5109","Iowa St","Baylor",3,4,0.571428571428571,7
"5110","Iowa St","Boise St",0,1,1,1
"5111","Iowa St","BYU",0,2,1,2
"5112","Iowa St","Campbell",0,1,1,1
"5113","Iowa St","Cincinnati",1,0,0,1
"5114","Iowa St","Drake",0,2,1,2
"5115","Iowa St","FL Gulf Coast",0,1,1,1
"5116","Iowa St","George Mason",0,1,1,1
"5117","Iowa St","Georgia St",0,1,1,1
"5118","Iowa St","Iowa",1,2,0.666666666666667,3
"5119","Iowa St","Kansas",5,3,0.375,8
"5120","Iowa St","Kansas St",3,4,0.571428571428571,7
"5121","Iowa St","Lamar",0,1,1,1
"5122","Iowa St","Maryland",1,0,0,1
"5123","Iowa St","Michigan",0,1,1,1
"5124","Iowa St","Missouri KC",0,3,1,3
"5125","Iowa St","MS Valley St",0,1,1,1
"5126","Iowa St","NC A&T",0,1,1,1
"5127","Iowa St","NE Omaha",0,1,1,1
"5128","Iowa St","N Illinois",0,1,1,1
"5129","Iowa St","Northern Iowa",0,1,1,1
"5130","Iowa St","Oakland",0,1,1,1
"5131","Iowa St","Oklahoma",3,4,0.571428571428571,7
"5132","Iowa St","Oklahoma St",1,5,0.833333333333333,6
"5133","Iowa St","South Carolina",1,0,0,1
"5134","Iowa St","Southern Univ",0,2,1,2
"5135","Iowa St","TAM C. Christi",0,1,1,1
"5136","Iowa St","TCU",0,6,1,6
"5137","Iowa St","Texas",2,5,0.714285714285714,7
"5138","Iowa St","Texas Tech",2,4,0.666666666666667,6
"5139","Iowa St","UNC Wilmington",0,1,1,1
"5140","Iowa St","UNLV",1,0,0,1
"5141","Iowa St","West Virginia",1,5,0.833333333333333,6
"5142","Iowa St","Yale",0,1,1,1
"5143","IPFW","Auburn",1,0,0,1
"5144","IPFW","Bowling Green",0,2,1,2
"5145","IPFW","Bradley",0,1,1,1
"5146","IPFW","Cal Poly SLO",1,0,0,1
"5147","IPFW","Dartmouth",1,2,0.666666666666667,3
"5148","IPFW","Dayton",1,0,0,1
"5149","IPFW","Denver",1,3,0.75,4
"5150","IPFW","Drake",1,0,0,1
"5151","IPFW","Edwardsville",0,2,1,2
"5152","IPFW","E Illinois",1,2,0.666666666666667,3
"5153","IPFW","E Kentucky",1,0,0,1
"5154","IPFW","E Michigan",1,0,0,1
"5155","IPFW","Georgia Tech",1,0,0,1
"5156","IPFW","Illinois",1,0,0,1
"5157","IPFW","Illinois St",1,0,0,1
"5158","IPFW","IUPUI",2,5,0.714285714285714,7
"5159","IPFW","Jacksonville",0,1,1,1
"5160","IPFW","Kennesaw",0,2,1,2
"5161","IPFW","Miami OH",1,2,0.666666666666667,3
"5162","IPFW","Missouri KC",1,1,0.5,2
"5163","IPFW","Navy",1,1,0.5,2
"5164","IPFW","N Dakota St",5,2,0.285714285714286,7
"5165","IPFW","NE Omaha",2,4,0.666666666666667,6
"5166","IPFW","Notre Dame",1,0,0,1
"5167","IPFW","Oakland",0,2,1,2
"5168","IPFW","Oral Roberts",1,1,0.5,2
"5169","IPFW","Purdue",1,0,0,1
"5170","IPFW","S Dakota St",4,3,0.428571428571429,7
"5171","IPFW","South Dakota",3,4,0.571428571428571,7
"5172","IPFW","Stetson",0,1,1,1
"5173","IPFW","TAM C. Christi",1,0,0,1
"5174","IPFW","Tennessee Tech",0,1,1,1
"5175","IPFW","TX Pan American",0,2,1,2
"5176","IPFW","Valparaiso",2,0,0,2
"5177","IPFW","W Illinois",3,3,0.5,6
"5178","IPFW","IU Kokomo",0,1,1,1
"5179","IPFW","Judson IL",0,1,1,1
"5180","IPFW","Kalamazoo",0,1,1,1
"5181","IPFW","Manchester",0,1,1,1
"5182","IPFW","MI Dearborn",0,1,1,1
"5183","IPFW","Purdue Calumet",0,1,1,1
"5184","IUPUI","Ball St",0,2,1,2
"5185","IUPUI","Bowling Green",0,1,1,1
"5186","IUPUI","Bradley",1,1,0.5,2
"5187","IUPUI","Butler",1,0,0,1
"5188","IUPUI","Chattanooga",1,0,0,1
"5189","IUPUI","Denver",1,3,0.75,4
"5190","IUPUI","Drake",2,0,0,2
"5191","IUPUI","E Kentucky",1,0,0,1
"5192","IUPUI","Evansville",2,0,0,2
"5193","IUPUI","Gardner Webb",1,0,0,1
"5194","IUPUI","Georgia St",1,0,0,1
"5195","IUPUI","Howard",1,0,0,1
"5196","IUPUI","Indiana St",3,0,0,3
"5197","IUPUI","IPFW",5,2,0.285714285714286,7
"5198","IUPUI","Lamar",1,0,0,1
"5199","IUPUI","Marquette",1,0,0,1
"5200","IUPUI","Maryland",1,0,0,1
"5201","IUPUI","Michigan",1,0,0,1
"5202","IUPUI","Missouri",1,0,0,1
"5203","IUPUI","Missouri KC",2,0,0,2
"5204","IUPUI","NC Central",1,1,0.5,2
"5205","IUPUI","N Dakota St",6,0,0,6
"5206","IUPUI","NE Omaha",5,1,0.166666666666667,6
"5207","IUPUI","Nicholls St",1,0,0,1
"5208","IUPUI","North Texas",1,0,0,1
"5209","IUPUI","Northwestern",1,0,0,1
"5210","IUPUI","Oakland",2,0,0,2
"5211","IUPUI","Oral Roberts",3,0,0,3
"5212","IUPUI","Pepperdine",0,1,1,1
"5213","IUPUI","Purdue",1,0,0,1
"5214","IUPUI","Richmond",1,0,0,1
"5215","IUPUI","S Dakota St",6,0,0,6
"5216","IUPUI","SE Missouri St",2,0,0,2
"5217","IUPUI","South Alabama",0,1,1,1
"5218","IUPUI","South Dakota",5,1,0.166666666666667,6
"5219","IUPUI","Utah Valley",1,1,0.5,2
"5220","IUPUI","Valparaiso",1,0,0,1
"5221","IUPUI","W Illinois",5,1,0.166666666666667,6
"5222","IUPUI","WI Milwaukee",1,1,0.5,2
"5223","IUPUI","W Kentucky",1,0,0,1
"5224","IUPUI","Xavier",1,0,0,1
"5225","IUPUI","Cincinnati Chr",0,1,1,1
"5226","IUPUI","Indiana NW",0,1,1,1
"5227","IUPUI","Judson IL",0,1,1,1
"5228","Jackson St","Air Force",1,1,0.5,2
"5229","Jackson St","Alabama A&M",3,3,0.5,6
"5230","Jackson St","Alabama St",4,2,0.333333333333333,6
"5231","Jackson St","Alcorn St",2,4,0.666666666666667,6
"5232","Jackson St","Arkansas St",1,0,0,1
"5233","Jackson St","Ark Pine Bluff",4,2,0.333333333333333,6
"5234","Jackson St","Baylor",1,0,0,1
"5235","Jackson St","Colorado",1,0,0,1
"5236","Jackson St","Drake",1,0,0,1
"5237","Jackson St","Evansville",0,1,1,1
"5238","Jackson St","Grambling",1,6,0.857142857142857,7
"5239","Jackson St","Hofstra",1,0,0,1
"5240","Jackson St","Jacksonville",0,1,1,1
"5241","Jackson St","Louisiana Tech",2,0,0,2
"5242","Jackson St","Loyola-Chicago",1,0,0,1
"5243","Jackson St","Memphis",1,0,0,1
"5244","Jackson St","Mississippi St",1,0,0,1
"5245","Jackson St","MS Valley St",2,4,0.666666666666667,6
"5246","Jackson St","NC Central",1,0,0,1
"5247","Jackson St","NC State",1,0,0,1
"5248","Jackson St","North Texas",1,0,0,1
"5249","Jackson St","Prairie View",6,1,0.142857142857143,7
"5250","Jackson St","Seattle",0,1,1,1
"5251","Jackson St","Southern Miss",1,1,0.5,2
"5252","Jackson St","Southern Univ",5,1,0.166666666666667,6
"5253","Jackson St","South Florida",1,0,0,1
"5254","Jackson St","St Bonaventure",1,0,0,1
"5255","Jackson St","St Mary's CA",1,0,0,1
"5256","Jackson St","Texas Tech",1,0,0,1
"5257","Jackson St","TN Martin",0,1,1,1
"5258","Jackson St","Tulane",2,0,0,2
"5259","Jackson St","Tulsa",1,0,0,1
"5260","Jackson St","TX Southern",4,2,0.333333333333333,6
"5261","Jackson St","UAB",1,0,0,1
"5262","Jackson St","ULL",1,1,0.5,2
"5263","Jackson St","Washington",1,0,0,1
"5264","Jackson St","Washington St",1,0,0,1
"5265","Jackson St","Wyoming",1,0,0,1
"5266","Jacksonville","Appalachian St",1,0,0,1
"5267","Jacksonville","Ark Little Rock",1,0,0,1
"5268","Jacksonville","Bethune-Cookman",1,0,0,1
"5269","Jacksonville","ETSU",2,2,0.5,4
"5270","Jacksonville","FL Atlantic",2,0,0,2
"5271","Jacksonville","FL Gulf Coast",5,2,0.285714285714286,7
"5272","Jacksonville","Florida",2,0,0,2
"5273","Jacksonville","Florida A&M",0,2,1,2
"5274","Jacksonville","Florida St",1,0,0,1
"5275","Jacksonville","Furman",0,1,1,1
"5276","Jacksonville","Gardner Webb",1,1,0.5,2
"5277","Jacksonville","Georgia",1,0,0,1
"5278","Jacksonville","Hofstra",1,0,0,1
"5279","Jacksonville","Indiana",1,0,0,1
"5280","Jacksonville","IPFW",1,0,0,1
"5281","Jacksonville","Jackson St",1,0,0,1
"5282","Jacksonville","Jacksonville St",0,1,1,1
"5283","Jacksonville","Kennesaw",3,3,0.5,6
"5284","Jacksonville","Lipscomb",4,2,0.333333333333333,6
"5285","Jacksonville","Mercer",4,1,0.2,5
"5286","Jacksonville","Miami FL",1,0,0,1
"5287","Jacksonville","Mississippi St",1,0,0,1
"5288","Jacksonville","Missouri St",0,1,1,1
"5289","Jacksonville","NC State",1,0,0,1
"5290","Jacksonville","N Kentucky",3,3,0.5,6
"5291","Jacksonville","North Florida",4,2,0.333333333333333,6
"5292","Jacksonville","Rider",1,0,0,1
"5293","Jacksonville","Samford",2,0,0,2
"5294","Jacksonville","S Carolina St",1,1,0.5,2
"5295","Jacksonville","SC Upstate",3,3,0.5,6
"5296","Jacksonville","South Carolina",1,0,0,1
"5297","Jacksonville","South Florida",1,0,0,1
"5298","Jacksonville","Stetson",3,3,0.5,6
"5299","Jacksonville","UCF",1,0,0,1
"5300","Jacksonville","Wake Forest",1,0,0,1
"5301","Jacksonville","WI Milwaukee",0,1,1,1
"5302","Jacksonville","Wofford",1,0,0,1
"5303","Jacksonville","Florida Col",0,1,1,1
"5304","Jacksonville","Florida National",0,1,1,1
"5305","Jacksonville","Trinity Bap",0,2,1,2
"5306","Jacksonville","Truett-McConnell",0,1,1,1
"5307","Jacksonville St","Air Force",1,0,0,1
"5308","Jacksonville St","Alabama A&M",0,3,1,3
"5309","Jacksonville St","Alabama St",2,0,0,2
"5310","Jacksonville St","Alcorn St",0,2,1,2
"5311","Jacksonville St","Ark Little Rock",1,0,0,1
"5312","Jacksonville St","Auburn",1,0,0,1
"5313","Jacksonville St","Austin Peay",0,3,1,3
"5314","Jacksonville St","Belmont",5,1,0.166666666666667,6
"5315","Jacksonville St","Bradley",1,0,0,1
"5316","Jacksonville St","Chicago St",1,0,0,1
"5317","Jacksonville St","Cleveland St",1,0,0,1
"5318","Jacksonville St","C Michigan",1,1,0.5,2
"5319","Jacksonville St","Coppin St",0,1,1,1
"5320","Jacksonville St","Dartmouth",1,1,0.5,2
"5321","Jacksonville St","Edwardsville",1,2,0.666666666666667,3
"5322","Jacksonville St","E Illinois",2,1,0.333333333333333,3
"5323","Jacksonville St","E Kentucky",5,1,0.166666666666667,6
"5324","Jacksonville St","E Michigan",0,1,1,1
"5325","Jacksonville St","Florida St",1,0,0,1
"5326","Jacksonville St","Illinois",1,0,0,1
"5327","Jacksonville St","Jacksonville",1,0,0,1
"5328","Jacksonville St","Louisville",1,0,0,1
"5329","Jacksonville St","Marshall",1,0,0,1
"5330","Jacksonville St","Memphis",1,0,0,1
"5331","Jacksonville St","Morehead St",5,1,0.166666666666667,6
"5332","Jacksonville St","Murray St",2,1,0.333333333333333,3
"5333","Jacksonville St","NC A&T",0,1,1,1
"5334","Jacksonville St","N Colorado",1,0,0,1
"5335","Jacksonville St","Nebraska",1,0,0,1
"5336","Jacksonville St","Northern Arizona",0,1,1,1
"5337","Jacksonville St","Oregon",1,0,0,1
"5338","Jacksonville St","Presbyterian",0,1,1,1
"5339","Jacksonville St","Savannah St",0,1,1,1
"5340","Jacksonville St","SE Missouri St",2,1,0.333333333333333,3
"5341","Jacksonville St","Tennessee St",4,2,0.333333333333333,6
"5342","Jacksonville St","Tennessee Tech",4,2,0.333333333333333,6
"5343","Jacksonville St","TN Martin",1,2,0.666666666666667,3
"5344","Jacksonville St","UNC Asheville",0,2,1,2
"5345","Jacksonville St","UNLV",1,0,0,1
"5346","Jacksonville St","Winthrop",0,1,1,1
"5347","Jacksonville St","Dalton St",0,1,1,1
"5348","Jacksonville St","Fort Valley St",0,2,1,2
"5349","Jacksonville St","Miles",0,1,1,1
"5350","James Madison","Ball St",0,2,1,2
"5351","James Madison","Campbell",0,1,1,1
"5352","James Madison","Col Charleston",1,3,0.75,4
"5353","James Madison","Colgate",0,1,1,1
"5354","James Madison","Delaware",2,4,0.666666666666667,6
"5355","James Madison","Detroit",1,0,0,1
"5356","James Madison","Drexel",2,4,0.666666666666667,6
"5357","James Madison","Duquesne",1,0,0,1
"5358","James Madison","East Carolina",1,0,0,1
"5359","James Madison","Elon",0,2,1,2
"5360","James Madison","ETSU",0,1,1,1
"5361","James Madison","George Mason",2,0,0,2
"5362","James Madison","Georgia St",2,0,0,2
"5363","James Madison","G Washington",1,0,0,1
"5364","James Madison","Hampton",1,1,0.5,2
"5365","James Madison","High Point",1,1,0.5,2
"5366","James Madison","Hofstra",2,4,0.666666666666667,6
"5367","James Madison","Longwood",0,1,1,1
"5368","James Madison","Miami OH",1,0,0,1
"5369","James Madison","N Dakota St",1,0,0,1
"5370","James Madison","N Illinois",0,1,1,1
"5371","James Madison","Norfolk St",1,0,0,1
"5372","James Madison","Northeastern",4,1,0.2,5
"5373","James Madison","Ohio St",1,0,0,1
"5374","James Madison","Old Dominion",0,2,1,2
"5375","James Madison","Radford",0,1,1,1
"5376","James Madison","Richmond",2,1,0.333333333333333,3
"5377","James Madison","Sacred Heart",0,1,1,1
"5378","James Madison","Sam Houston St",1,0,0,1
"5379","James Madison","San Diego",0,1,1,1
"5380","James Madison","San Jose St",0,2,1,2
"5381","James Madison","SF Austin",1,0,0,1
"5382","James Madison","Towson",4,3,0.428571428571429,7
"5383","James Madison","UCLA",1,0,0,1
"5384","James Madison","UNC Greensboro",1,1,0.5,2
"5385","James Madison","UNC Wilmington",2,4,0.666666666666667,6
"5386","James Madison","Valparaiso",2,0,0,2
"5387","James Madison","Virginia",2,0,0,2
"5388","James Madison","William & Mary",4,2,0.333333333333333,6
"5389","James Madison","WI Milwaukee",1,0,0,1
"5390","James Madison","Winthrop",1,1,0.5,2
"5391","James Madison","Youngstown St",0,1,1,1
"5392","Kansas","American Univ",0,1,1,1
"5393","Kansas","Baylor",1,6,0.857142857142857,7
"5394","Kansas","Belmont",0,1,1,1
"5395","Kansas","Chattanooga",0,1,1,1
"5396","Kansas","Colorado",1,1,0.5,2
"5397","Kansas","Duke",0,1,1,1
"5398","Kansas","Florida",1,1,0.5,2
"5399","Kansas","Georgetown",0,2,1,2
"5400","Kansas","Iona",0,1,1,1
"5401","Kansas","Iowa St",3,5,0.625,8
"5402","Kansas","Kansas St",2,4,0.666666666666667,6
"5403","Kansas","Kent",0,1,1,1
"5404","Kansas","Kentucky",1,0,0,1
"5405","Kansas","Lafayette",0,1,1,1
"5406","Kansas","Michigan St",1,1,0.5,2
"5407","Kansas","New Mexico",0,1,1,1
"5408","Kansas","Ohio St",0,1,1,1
"5409","Kansas","Oklahoma",2,4,0.666666666666667,6
"5410","Kansas","Oklahoma St",3,4,0.571428571428571,7
"5411","Kansas","Oregon St",0,1,1,1
"5412","Kansas","Rhode Island",0,1,1,1
"5413","Kansas","Richmond",0,1,1,1
"5414","Kansas","Rider",0,1,1,1
"5415","Kansas","San Diego St",1,0,0,1
"5416","Kansas","San Jose St",0,1,1,1
"5417","Kansas","Santa Barbara",0,1,1,1
"5418","Kansas","SE Missouri St",0,1,1,1
"5419","Kansas","St Louis",0,1,1,1
"5420","Kansas","TCU",1,6,0.857142857142857,7
"5421","Kansas","Temple",1,1,0.5,2
"5422","Kansas","Tennessee",0,1,1,1
"5423","Kansas","Texas",1,5,0.833333333333333,6
"5424","Kansas","Texas Tech",0,6,1,6
"5425","Kansas","Toledo",0,1,1,1
"5426","Kansas","Towson",0,1,1,1
"5427","Kansas","ULM",0,1,1,1
"5428","Kansas","UNLV",0,1,1,1
"5429","Kansas","Utah",0,1,1,1
"5430","Kansas","UTEP",0,1,1,1
"5431","Kansas","Villanova",1,0,0,1
"5432","Kansas","Wake Forest",0,1,1,1
"5433","Kansas","Washington St",0,1,1,1
"5434","Kansas","West Virginia",2,4,0.666666666666667,6
"5435","Kansas St","Arizona",1,0,0,1
"5436","Kansas St","Baylor",3,3,0.5,6
"5437","Kansas St","Bradley",0,1,1,1
"5438","Kansas St","Cent Arkansas",0,1,1,1
"5439","Kansas St","Charlotte",1,0,0,1
"5440","Kansas St","Delaware",0,1,1,1
"5441","Kansas St","Florida",0,1,1,1
"5442","Kansas St","Georgetown",1,0,0,1
"5443","Kansas St","Georgia",1,0,0,1
"5444","Kansas St","Gonzaga",1,1,0.5,2
"5445","Kansas St","G Washington",0,2,1,2
"5446","Kansas St","Iowa St",4,3,0.428571428571429,7
"5447","Kansas St","Kansas",4,2,0.333333333333333,6
"5448","Kansas St","Lamar",0,1,1,1
"5449","Kansas St","Long Beach St",1,2,0.666666666666667,3
"5450","Kansas St","Michigan",1,0,0,1
"5451","Kansas St","Mississippi",0,1,1,1
"5452","Kansas St","Missouri KC",0,2,1,2
"5453","Kansas St","N Colorado",1,0,0,1
"5454","Kansas St","NE Omaha",0,1,1,1
"5455","Kansas St","North Dakota",0,1,1,1
"5456","Kansas St","North Florida",0,1,1,1
"5457","Kansas St","Oklahoma",1,5,0.833333333333333,6
"5458","Kansas St","Oklahoma St",3,3,0.5,6
"5459","Kansas St","Oral Roberts",0,1,1,1
"5460","Kansas St","Pittsburgh",1,0,0,1
"5461","Kansas St","Purdue",0,1,1,1
"5462","Kansas St","Savannah St",0,1,1,1
"5463","Kansas St","SC Upstate",0,1,1,1
"5464","Kansas St","South Dakota",0,2,1,2
"5465","Kansas St","Southern Utah",0,1,1,1
"5466","Kansas St","TCU",2,5,0.714285714285714,7
"5467","Kansas St","Tennessee",1,0,0,1
"5468","Kansas St","Texas",3,3,0.5,6
"5469","Kansas St","Texas A&M",0,1,1,1
"5470","Kansas St","Texas Tech",1,5,0.833333333333333,6
"5471","Kansas St","Troy",0,1,1,1
"5472","Kansas St","Tulane",0,1,1,1
"5473","Kansas St","TX Southern",1,1,0.5,2
"5474","Kansas St","West Virginia",3,3,0.5,6
"5475","Kennesaw","Alcorn St",0,1,1,1
"5476","Kennesaw","Butler",1,0,0,1
"5477","Kennesaw","California",1,0,0,1
"5478","Kennesaw","Charlotte",1,0,0,1
"5479","Kennesaw","Chattanooga",1,2,0.666666666666667,3
"5480","Kennesaw","Cincinnati",1,0,0,1
"5481","Kennesaw","E Kentucky",2,0,0,2
"5482","Kennesaw","Elon",1,0,0,1
"5483","Kennesaw","ETSU",4,0,0,4
"5484","Kennesaw","FL Gulf Coast",6,0,0,6
"5485","Kennesaw","Florida Intl",2,0,0,2
"5486","Kennesaw","Ga Southern",2,0,0,2
"5487","Kennesaw","Georgia Tech",1,0,0,1
"5488","Kennesaw","Illinois",1,0,0,1
"5489","Kennesaw","Indiana",1,0,0,1
"5490","Kennesaw","IPFW",2,0,0,2
"5491","Kennesaw","Jacksonville",3,3,0.5,6
"5492","Kennesaw","Kent",2,0,0,2
"5493","Kennesaw","Lipscomb",6,0,0,6
"5494","Kennesaw","Mercer",4,1,0.2,5
"5495","Kennesaw","Mississippi St",1,0,0,1
"5496","Kennesaw","N Dakota St",1,0,0,1
"5497","Kennesaw","N Kentucky",5,1,0.166666666666667,6
"5498","Kennesaw","North Florida",6,0,0,6
"5499","Kennesaw","Notre Dame",1,0,0,1
"5500","Kennesaw","Pittsburgh",1,0,0,1
"5501","Kennesaw","Radford",1,0,0,1
"5502","Kennesaw","Samford",0,1,1,1
"5503","Kennesaw","S Carolina St",0,1,1,1
"5504","Kennesaw","SC Upstate",6,1,0.142857142857143,7
"5505","Kennesaw","Stetson",3,3,0.5,6
"5506","Kennesaw","Syracuse",1,0,0,1
"5507","Kennesaw","Tennessee",1,0,0,1
"5508","Kennesaw","Tennessee St",1,0,0,1
"5509","Kennesaw","TN Martin",1,0,0,1
"5510","Kennesaw","Towson",1,0,0,1
"5511","Kennesaw","Youngstown St",1,1,0.5,2
"5512","Kennesaw","Thomas GA",0,1,1,1
"5513","Kennesaw","Truett-McConnell",0,1,1,1
"5514","Kennesaw","UMBC",1,0,0,1
"5515","Kennesaw","Warren Wilson",0,1,1,1
"5516","Kennesaw","Paine",0,1,1,1
"5517","Kent","Akron",4,4,0.5,8
"5518","Kent","Arkansas St",0,1,1,1
"5519","Kent","Ark Little Rock",0,1,1,1
"5520","Kent","Ball St",0,4,1,4
"5521","Kent","Bethune-Cookman",0,1,1,1
"5522","Kent","Bowling Green",3,3,0.5,6
"5523","Kent","Bucknell",2,0,0,2
"5524","Kent","Buffalo",4,2,0.333333333333333,6
"5525","Kent","Chicago St",0,1,1,1
"5526","Kent","Cleveland St",1,1,0.5,2
"5527","Kent","C Michigan",1,3,0.75,4
"5528","Kent","Col Charleston",0,1,1,1
"5529","Kent","Drexel",0,1,1,1
"5530","Kent","E Michigan",1,2,0.666666666666667,3
"5531","Kent","IL Chicago",0,1,1,1
"5532","Kent","Kansas",1,0,0,1
"5533","Kent","Kennesaw",0,2,1,2
"5534","Kent","Loyola-Chicago",1,1,0.5,2
"5535","Kent","Miami OH",3,4,0.571428571428571,7
"5536","Kent","NC A&T",0,1,1,1
"5537","Kent","N Dakota St",0,1,1,1
"5538","Kent","Nebraska",0,1,1,1
"5539","Kent","Niagara",0,1,1,1
"5540","Kent","N Illinois",2,2,0.5,4
"5541","Kent","Ohio",3,3,0.5,6
"5542","Kent","Princeton",2,0,0,2
"5543","Kent","SC Upstate",0,1,1,1
"5544","Kent","Seton Hall",1,0,0,1
"5545","Kent","S Illinois",0,1,1,1
"5546","Kent","St Francis PA",0,1,1,1
"5547","Kent","St Peter's",0,1,1,1
"5548","Kent","Temple",1,1,0.5,2
"5549","Kent","Toledo",2,2,0.5,4
"5550","Kent","TX Pan American",0,1,1,1
"5551","Kent","UTEP",1,0,0,1
"5552","Kent","Valparaiso",1,0,0,1
"5553","Kent","W Carolina",0,1,1,1
"5554","Kent","W Michigan",3,0,0,3
"5555","Kent","Xavier",1,0,0,1
"5556","Kent","Yale",1,0,0,1
"5557","Kent","Youngstown St",0,3,1,3
"5558","Kent","Ohio Northern",0,1,1,1
"5559","Kent","Malone",0,1,1,1
"5560","Kentucky","Alabama",1,3,0.75,4
"5561","Kentucky","Arkansas",3,2,0.4,5
"5562","Kentucky","Auburn",0,5,1,5
"5563","Kentucky","Baylor",2,0,0,2
"5564","Kentucky","Belmont",0,1,1,1
"5565","Kentucky","Boise St",0,1,1,1
"5566","Kentucky","Boston Univ",0,1,1,1
"5567","Kentucky","Buffalo",0,1,1,1
"5568","Kentucky","Cleveland St",0,1,1,1
"5569","Kentucky","Columbia",0,1,1,1
"5570","Kentucky","Duke",1,0,0,1
"5571","Kentucky","E Kentucky",0,1,1,1
"5572","Kentucky","E Michigan",0,2,1,2
"5573","Kentucky","Florida",4,4,0.5,8
"5574","Kentucky","Georgia",1,4,0.8,5
"5575","Kentucky","Kansas",0,1,1,1
"5576","Kentucky","Lafayette",0,1,1,1
"5577","Kentucky","Lipscomb",0,1,1,1
"5578","Kentucky","Long Island",0,1,1,1
"5579","Kentucky","Louisville",1,2,0.666666666666667,3
"5580","Kentucky","LSU",1,4,0.8,5
"5581","Kentucky","Marshall",0,1,1,1
"5582","Kentucky","Maryland",0,1,1,1
"5583","Kentucky","Michigan St",1,0,0,1
"5584","Kentucky","Mississippi",0,4,1,4
"5585","Kentucky","Mississippi St",0,4,1,4
"5586","Kentucky","Missouri",0,4,1,4
"5587","Kentucky","Montana St",0,1,1,1
"5588","Kentucky","Morehead St",0,1,1,1
"5589","Kentucky","N Kentucky",0,1,1,1
"5590","Kentucky","North Carolina",1,1,0.5,2
"5591","Kentucky","Notre Dame",1,0,0,1
"5592","Kentucky","Portland",0,1,1,1
"5593","Kentucky","Providence",0,2,1,2
"5594","Kentucky","Robert Morris",0,1,1,1
"5595","Kentucky","Samford",0,1,1,1
"5596","Kentucky","South Carolina",1,3,0.75,4
"5597","Kentucky","Tennessee",1,3,0.75,4
"5598","Kentucky","Texas",0,1,1,1
"5599","Kentucky","Texas A&M",1,3,0.75,4
"5600","Kentucky","UCLA",0,1,1,1
"5601","Kentucky","UNC Asheville",0,1,1,1
"5602","Kentucky","UT Arlington",0,2,1,2
"5603","Kentucky","Vanderbilt",0,4,1,4
"5604","Kentucky","Grand Canyon",0,1,1,1
"5605","Lafayette","American Univ",4,3,0.428571428571429,7
"5606","Lafayette","Army",4,2,0.333333333333333,6
"5607","Lafayette","Boston Univ",4,2,0.333333333333333,6
"5608","Lafayette","Bucknell",3,4,0.571428571428571,7
"5609","Lafayette","Colgate",3,3,0.5,6
"5610","Lafayette","Delaware",0,1,1,1
"5611","Lafayette","F Dickinson",1,1,0.5,2
"5612","Lafayette","Holy Cross",2,5,0.714285714285714,7
"5613","Lafayette","Kansas",1,0,0,1
"5614","Lafayette","Kentucky",1,0,0,1
"5615","Lafayette","Lehigh",2,5,0.714285714285714,7
"5616","Lafayette","Long Island",1,1,0.5,2
"5617","Lafayette","Loyola MD",2,3,0.6,5
"5618","Lafayette","Maryland",1,0,0,1
"5619","Lafayette","Minnesota",1,0,0,1
"5620","Lafayette","Monmouth NJ",1,0,0,1
"5621","Lafayette","Morehead St",1,0,0,1
"5622","Lafayette","Navy",2,4,0.666666666666667,6
"5623","Lafayette","NJIT",1,2,0.666666666666667,3
"5624","Lafayette","Penn",0,3,1,3
"5625","Lafayette","Princeton",2,1,0.333333333333333,3
"5626","Lafayette","Robert Morris",1,1,0.5,2
"5627","Lafayette","Sacred Heart",0,3,1,3
"5628","Lafayette","Seton Hall",1,0,0,1
"5629","Lafayette","Stanford",1,0,0,1
"5630","Lafayette","St Francis NY",2,0,0,2
"5631","Lafayette","St Francis PA",0,1,1,1
"5632","Lafayette","Villanova",1,0,0,1
"5633","Lafayette","Wagner",0,2,1,2
"5634","Lafayette","West Virginia",1,0,0,1
"5635","Lafayette","Yale",2,0,0,2
"5636","Lafayette","Immaculata",0,1,1,1
"5637","Lafayette","Susquehanna",0,1,1,1
"5638","Lamar","Alabama",1,0,0,1
"5639","Lamar","Arkansas St",2,1,0.333333333333333,3
"5640","Lamar","Baylor",1,0,0,1
"5641","Lamar","Butler",1,0,0,1
"5642","Lamar","Canisius",1,0,0,1
"5643","Lamar","Cent Arkansas",3,1,0.25,4
"5644","Lamar","Charlotte",1,0,0,1
"5645","Lamar","Colorado St",1,0,0,1
"5646","Lamar","George Mason",1,0,0,1
"5647","Lamar","Houston Bap",1,2,0.666666666666667,3
"5648","Lamar","Indiana",1,0,0,1
"5649","Lamar","Iowa St",1,0,0,1
"5650","Lamar","IUPUI",0,1,1,1
"5651","Lamar","Kansas St",1,0,0,1
"5652","Lamar","Long Island",1,1,0.5,2
"5653","Lamar","McNeese St",4,1,0.2,5
"5654","Lamar","New Orleans",2,1,0.333333333333333,3
"5655","Lamar","Nicholls St",3,1,0.25,4
"5656","Lamar","North Texas",1,0,0,1
"5657","Lamar","Northwestern LA",5,0,0,5
"5658","Lamar","Oral Roberts",3,0,0,3
"5659","Lamar","Purdue",1,0,0,1
"5660","Lamar","Rice",0,1,1,1
"5661","Lamar","Sam Houston St",6,0,0,6
"5662","Lamar","Savannah St",0,1,1,1
"5663","Lamar","SE Louisiana",4,1,0.2,5
"5664","Lamar","SF Austin",6,0,0,6
"5665","Lamar","SMU",1,0,0,1
"5666","Lamar","TAM C. Christi",2,2,0.5,4
"5667","Lamar","Tennessee Tech",1,0,0,1
"5668","Lamar","Texas St",2,0,0,2
"5669","Lamar","TX Pan American",3,0,0,3
"5670","Lamar","TX Southern",1,0,0,1
"5671","Lamar","ULL",1,0,0,1
"5672","Lamar","Utah",1,0,0,1
"5673","Lamar","Virginia",1,0,0,1
"5674","Lamar","Washington St",1,0,0,1
"5675","Lamar","Abilene Chr",0,3,1,3
"5676","Lamar","Champion Bap",0,1,1,1
"5677","Lamar","Grand Canyon",1,0,0,1
"5678","Lamar","Huston-Tillot",0,1,1,1
"5679","Lamar","Incarnate Word",2,1,0.333333333333333,3
"5680","Lamar","Milligan",0,1,1,1
"5681","Lamar","LSU-Alexandria",0,1,1,1
"5682","La Salle","American Univ",1,0,0,1
"5683","La Salle","Bucknell",1,0,0,1
"5684","La Salle","Butler",0,1,1,1
"5685","La Salle","Central Conn",1,0,0,1
"5686","La Salle","Charlotte",1,0,0,1
"5687","La Salle","Colgate",0,1,1,1
"5688","La Salle","Davidson",2,0,0,2
"5689","La Salle","Dayton",2,2,0.5,4
"5690","La Salle","Delaware",0,1,1,1
"5691","La Salle","Drexel",0,1,1,1
"5692","La Salle","Duquesne",0,4,1,4
"5693","La Salle","Fordham",1,3,0.75,4
"5694","La Salle","George Mason",2,0,0,2
"5695","La Salle","G Washington",1,4,0.8,5
"5696","La Salle","Hartford",0,2,1,2
"5697","La Salle","Hofstra",0,1,1,1
"5698","La Salle","Iona",0,1,1,1
"5699","La Salle","Manhattan",1,0,0,1
"5700","La Salle","Massachusetts",4,1,0.2,5
"5701","La Salle","Miami FL",2,0,0,2
"5702","La Salle","Morgan St",0,1,1,1
"5703","La Salle","Northeastern",0,1,1,1
"5704","La Salle","Northern Iowa",1,0,0,1
"5705","La Salle","Penn",0,3,1,3
"5706","La Salle","Penn St",1,1,0.5,2
"5707","La Salle","Providence",1,0,0,1
"5708","La Salle","Quinnipiac",0,2,1,2
"5709","La Salle","Rhode Island",2,2,0.5,4
"5710","La Salle","Richmond",1,2,0.666666666666667,3
"5711","La Salle","Rider",0,1,1,1
"5712","La Salle","Sacred Heart",0,1,1,1
"5713","La Salle","Siena",0,2,1,2
"5714","La Salle","St Bonaventure",2,3,0.6,5
"5715","La Salle","St Francis NY",0,1,1,1
"5716","La Salle","St Joseph's PA",2,3,0.6,5
"5717","La Salle","St Louis",3,0,0,3
"5718","La Salle","Stony Brook",0,1,1,1
"5719","La Salle","St Peter's",0,1,1,1
"5720","La Salle","Temple",2,1,0.333333333333333,3
"5721","La Salle","Towson",0,1,1,1
"5722","La Salle","VA Commonwealth",1,2,0.666666666666667,3
"5723","La Salle","Vanderbilt",1,0,0,1
"5724","La Salle","Villanova",2,1,0.333333333333333,3
"5725","La Salle","Virginia",1,0,0,1
"5726","La Salle","Wagner",0,1,1,1
"5727","La Salle","Xavier",1,0,0,1
"5728","Lehigh","American Univ",4,3,0.428571428571429,7
"5729","Lehigh","Arizona St",0,1,1,1
"5730","Lehigh","Army",2,4,0.666666666666667,6
"5731","Lehigh","Baylor",1,0,0,1
"5732","Lehigh","Boston Univ",2,2,0.5,4
"5733","Lehigh","Bryant",2,0,0,2
"5734","Lehigh","Bucknell",3,3,0.5,6
"5735","Lehigh","Canisius",1,0,0,1
"5736","Lehigh","Colgate",4,3,0.428571428571429,7
"5737","Lehigh","Columbia",1,0,0,1
"5738","Lehigh","DePaul",0,1,1,1
"5739","Lehigh","Fairfield",0,1,1,1
"5740","Lehigh","F Dickinson",0,1,1,1
"5741","Lehigh","Fordham",1,1,0.5,2
"5742","Lehigh","Holy Cross",4,3,0.428571428571429,7
"5743","Lehigh","Houston",1,0,0,1
"5744","Lehigh","Lafayette",5,2,0.285714285714286,7
"5745","Lehigh","Long Island",0,2,1,2
"5746","Lehigh","Loyola MD",2,2,0.5,4
"5747","Lehigh","Minnesota",1,0,0,1
"5748","Lehigh","Navy",0,6,1,6
"5749","Lehigh","North Texas",0,1,1,1
"5750","Lehigh","Penn",0,1,1,1
"5751","Lehigh","Pittsburgh",2,0,0,2
"5752","Lehigh","Quinnipiac",1,2,0.666666666666667,3
"5753","Lehigh","Rider",1,1,0.5,2
"5754","Lehigh","Robert Morris",0,1,1,1
"5755","Lehigh","Sacred Heart",0,2,1,2
"5756","Lehigh","S Dakota St",1,0,0,1
"5757","Lehigh","St Francis PA",0,3,1,3
"5758","Lehigh","TX Southern",0,1,1,1
"5759","Lehigh","VA Commonwealth",1,0,0,1
"5760","Lehigh","Villanova",1,0,0,1
"5761","Lehigh","UMBC",0,2,1,2
"5762","Lehigh","PSU Mont Alto",0,1,1,1
"5763","Liberty","Austin Peay",1,1,0.5,2
"5764","Liberty","Campbell",1,5,0.833333333333333,6
"5765","Liberty","Charleston So",4,0,0,4
"5766","Liberty","Coastal Car",3,2,0.4,5
"5767","Liberty","Delaware",1,1,0.5,2
"5768","Liberty","Furman",1,1,0.5,2
"5769","Liberty","Gardner Webb",3,0,0,3
"5770","Liberty","Georgetown",1,0,0,1
"5771","Liberty","Georgia St",1,0,0,1
"5772","Liberty","Hampton",0,1,1,1
"5773","Liberty","High Point",5,0,0,5
"5774","Liberty","Howard",1,1,0.5,2
"5775","Liberty","Iona",1,0,0,1
"5776","Liberty","Longwood",4,2,0.333333333333333,6
"5777","Liberty","Miami OH",1,0,0,1
"5778","Liberty","Missouri St",1,0,0,1
"5779","Liberty","Morgan St",2,0,0,2
"5780","Liberty","North Florida",1,0,0,1
"5781","Liberty","Presbyterian",3,1,0.25,4
"5782","Liberty","Princeton",2,0,0,2
"5783","Liberty","Radford",3,3,0.5,6
"5784","Liberty","Richmond",1,0,0,1
"5785","Liberty","Sam Houston St",1,1,0.5,2
"5786","Liberty","Southern Miss",1,0,0,1
"5787","Liberty","St Francis NY",1,0,0,1
"5788","Liberty","UC Irvine",1,0,0,1
"5789","Liberty","UNC Asheville",5,0,0,5
"5790","Liberty","UNC Wilmington",2,0,0,2
"5791","Liberty","Virginia",1,0,0,1
"5792","Liberty","Virginia Tech",1,0,0,1
"5793","Liberty","VMI",3,1,0.25,4
"5794","Liberty","W Carolina",1,1,0.5,2
"5795","Liberty","William & Mary",2,0,0,2
"5796","Liberty","Winthrop",5,0,0,5
"5797","Liberty","Bluefield VA",0,1,1,1
"5798","Liberty","Central Penn",0,1,1,1
"5799","Liberty","Cincinnati Chr",0,1,1,1
"5800","Liberty","Greensboro",0,1,1,1
"5801","Liberty","Randolph Col",0,2,1,2
"5802","Liberty","Southeastern FL",0,1,1,1
"5803","Lipscomb","Austin Peay",0,4,1,4
"5804","Lipscomb","Belmont",6,0,0,6
"5805","Lipscomb","Chattanooga",1,0,0,1
"5806","Lipscomb","Colorado",1,0,0,1
"5807","Lipscomb","ETSU",3,2,0.4,5
"5808","Lipscomb","FL Gulf Coast",3,3,0.5,6
"5809","Lipscomb","Gardner Webb",0,1,1,1
"5810","Lipscomb","Georgetown",1,0,0,1
"5811","Lipscomb","Georgia",1,0,0,1
"5812","Lipscomb","Jacksonville",2,4,0.666666666666667,6
"5813","Lipscomb","Kennesaw",0,6,1,6
"5814","Lipscomb","Kentucky",1,0,0,1
"5815","Lipscomb","Memphis",1,0,0,1
"5816","Lipscomb","Mercer",5,0,0,5
"5817","Lipscomb","Mississippi",1,0,0,1
"5818","Lipscomb","Missouri",1,0,0,1
"5819","Lipscomb","Murray St",2,0,0,2
"5820","Lipscomb","N Kentucky",2,5,0.714285714285714,7
"5821","Lipscomb","North Florida",6,1,0.142857142857143,7
"5822","Lipscomb","Princeton",1,0,0,1
"5823","Lipscomb","SC Upstate",4,2,0.333333333333333,6
"5824","Lipscomb","Stetson",4,2,0.333333333333333,6
"5825","Lipscomb","Tennessee St",0,2,1,2
"5826","Lipscomb","Tennessee Tech",1,2,0.666666666666667,3
"5827","Lipscomb","Texas",1,0,0,1
"5828","Lipscomb","TN Martin",0,2,1,2
"5829","Lipscomb","Vanderbilt",2,0,0,2
"5830","Lipscomb","Oakland City",0,1,1,1
"5831","Lipscomb","Berry",0,1,1,1
"5832","Lipscomb","Rhodes",0,1,1,1
"5833","Lipscomb","Transylvania",0,1,1,1
"5834","Long Beach St","Arizona",2,0,0,2
"5835","Long Beach St","BYU",1,0,0,1
"5836","Long Beach St","Cal Poly SLO",2,4,0.666666666666667,6
"5837","Long Beach St","Creighton",1,0,0,1
"5838","Long Beach St","CS Fullerton",1,6,0.857142857142857,7
"5839","Long Beach St","CS Northridge",2,5,0.714285714285714,7
"5840","Long Beach St","Fresno St",1,1,0.5,2
"5841","Long Beach St","Hawaii",3,4,0.571428571428571,7
"5842","Long Beach St","Kansas St",2,1,0.333333333333333,3
"5843","Long Beach St","Louisville",1,0,0,1
"5844","Long Beach St","Loy Marymount",1,1,0.5,2
"5845","Long Beach St","Michigan",1,0,0,1
"5846","Long Beach St","Missouri",1,0,0,1
"5847","Long Beach St","NC State",1,0,0,1
"5848","Long Beach St","Nevada",0,2,1,2
"5849","Long Beach St","North Carolina",1,0,0,1
"5850","Long Beach St","Ohio St",1,0,0,1
"5851","Long Beach St","Pacific",1,1,0.5,2
"5852","Long Beach St","San Diego St",1,0,0,1
"5853","Long Beach St","Santa Barbara",3,3,0.5,6
"5854","Long Beach St","SF Austin",2,0,0,2
"5855","Long Beach St","St John's",1,0,0,1
"5856","Long Beach St","Syracuse",2,0,0,2
"5857","Long Beach St","Texas",1,0,0,1
"5858","Long Beach St","UC Davis",2,4,0.666666666666667,6
"5859","Long Beach St","UC Irvine",4,2,0.333333333333333,6
"5860","Long Beach St","UCLA",2,0,0,2
"5861","Long Beach St","UC Riverside",0,6,1,6
"5862","Long Beach St","USC",1,1,0.5,2
"5863","Long Beach St","VA Commonwealth",1,0,0,1
"5864","Long Beach St","Washington",2,0,0,2
"5865","Long Beach St","W Michigan",0,1,1,1
"5866","Long Beach St","Xavier",1,1,0.5,2
"5867","Long Beach St","Hawaii Pacific",0,1,1,1
"5868","Long Beach St","MT St-Billings",0,1,1,1
"5869","Long Beach St","S Francisco St",0,1,1,1
"5870","Long Beach St","Fresno Pacific",0,1,1,1
"5871","Long Island","Boston Univ",1,0,0,1
"5872","Long Island","Bryant",4,1,0.2,5
"5873","Long Island","Central Conn",1,4,0.8,5
"5874","Long Island","Columbia",0,1,1,1
"5875","Long Island","E Washington",1,0,0,1
"5876","Long Island","F Dickinson",2,3,0.6,5
"5877","Long Island","Florida Intl",0,1,1,1
"5878","Long Island","Hofstra",1,1,0.5,2
"5879","Long Island","Indiana",1,0,0,1
"5880","Long Island","Kentucky",1,0,0,1
"5881","Long Island","Lafayette",1,1,0.5,2
"5882","Long Island","Lamar",1,1,0.5,2
"5883","Long Island","Lehigh",2,0,0,2
"5884","Long Island","Maine",0,1,1,1
"5885","Long Island","Manhattan",0,1,1,1
"5886","Long Island","Maryland",1,0,0,1
"5887","Long Island","Monmouth NJ",0,2,1,2
"5888","Long Island","Morehead St",1,0,0,1
"5889","Long Island","Mt St Mary's",4,2,0.333333333333333,6
"5890","Long Island","New Hampshire",1,1,0.5,2
"5891","Long Island","NJIT",0,2,1,2
"5892","Long Island","Norfolk St",0,1,1,1
"5893","Long Island","Quinnipiac",1,2,0.666666666666667,3
"5894","Long Island","Rice",0,1,1,1
"5895","Long Island","Robert Morris",3,2,0.4,5
"5896","Long Island","Sacred Heart",2,3,0.6,5
"5897","Long Island","Sam Houston St",1,0,0,1
"5898","Long Island","Seton Hall",2,0,0,2
"5899","Long Island","St Francis NY",4,3,0.428571428571429,7
"5900","Long Island","St Francis PA",2,3,0.6,5
"5901","Long Island","St John's",1,0,0,1
"5902","Long Island","St Joseph's PA",1,0,0,1
"5903","Long Island","Stony Brook",1,0,0,1
"5904","Long Island","St Peter's",1,1,0.5,2
"5905","Long Island","Temple",2,0,0,2
"5906","Long Island","Texas St",0,1,1,1
"5907","Long Island","UC Irvine",1,0,0,1
"5908","Long Island","Wagner",6,1,0.142857142857143,7
"5909","Longwood","Arkansas",1,0,0,1
"5910","Longwood","Ball St",1,0,0,1
"5911","Longwood","Brown",1,0,0,1
"5912","Longwood","Campbell",2,3,0.6,5
"5913","Longwood","Canisius",1,0,0,1
"5914","Longwood","Charleston So",3,2,0.4,5
"5915","Longwood","Coastal Car",4,0,0,4
"5916","Longwood","Cornell",1,0,0,1
"5917","Longwood","Creighton",1,0,0,1
"5918","Longwood","Dartmouth",2,1,0.333333333333333,3
"5919","Longwood","E Kentucky",1,0,0,1
"5920","Longwood","E Michigan",1,0,0,1
"5921","Longwood","F Dickinson",1,0,0,1
"5922","Longwood","Florida A&M",0,1,1,1
"5923","Longwood","Gardner Webb",5,0,0,5
"5924","Longwood","Georgetown",1,0,0,1
"5925","Longwood","G Washington",1,0,0,1
"5926","Longwood","High Point",5,0,0,5
"5927","Longwood","Iowa",1,0,0,1
"5928","Longwood","James Madison",1,0,0,1
"5929","Longwood","Liberty",2,4,0.666666666666667,6
"5930","Longwood","Louisiana Tech",1,0,0,1
"5931","Longwood","Marshall",1,0,0,1
"5932","Longwood","Miami OH",1,0,0,1
"5933","Longwood","MS Valley St",1,0,0,1
"5934","Longwood","NC A&T",1,0,0,1
"5935","Longwood","Norfolk St",1,0,0,1
"5936","Longwood","Ohio",1,0,0,1
"5937","Longwood","Penn St",1,0,0,1
"5938","Longwood","Presbyterian",3,2,0.4,5
"5939","Longwood","Radford",4,2,0.333333333333333,6
"5940","Longwood","Seton Hall",1,0,0,1
"5941","Longwood","South Carolina",1,0,0,1
"5942","Longwood","St John's",1,0,0,1
"5943","Longwood","TCU",0,1,1,1
"5944","Longwood","TN Martin",2,0,0,2
"5945","Longwood","UNC Asheville",4,0,0,4
"5946","Longwood","UNC Greensboro",0,1,1,1
"5947","Longwood","VA Commonwealth",1,0,0,1
"5948","Longwood","VMI",4,0,0,4
"5949","Longwood","Winthrop",4,1,0.2,5
"5950","Longwood","Youngstown St",1,0,0,1
"5951","Longwood","Bluefield WV",0,1,1,1
"5952","Longwood","Mars Hill",0,1,1,1
"5953","Longwood","UMBC",1,0,0,1
"5954","Longwood","VA Intermont",0,1,1,1
"5955","Longwood","WV Tech",0,1,1,1
"5956","Longwood","Averett",0,1,1,1
"5957","Longwood","PSU-Beaver",0,1,1,1
"5958","Louisiana Tech","American Univ",0,1,1,1
"5959","Louisiana Tech","Ark Little Rock",0,2,1,2
"5960","Louisiana Tech","Cent Arkansas",0,1,1,1
"5961","Louisiana Tech","Charlotte",0,3,1,3
"5962","Louisiana Tech","Chattanooga",0,1,1,1
"5963","Louisiana Tech","Denver",1,1,0.5,2
"5964","Louisiana Tech","East Carolina",1,0,0,1
"5965","Louisiana Tech","FL Atlantic",0,2,1,2
"5966","Louisiana Tech","Florida Intl",0,2,1,2
"5967","Louisiana Tech","Georgia St",0,1,1,1
"5968","Louisiana Tech","Idaho",0,2,1,2
"5969","Louisiana Tech","IL Chicago",0,1,1,1
"5970","Louisiana Tech","Jackson St",0,2,1,2
"5971","Louisiana Tech","Longwood",0,1,1,1
"5972","Louisiana Tech","Marshall",0,2,1,2
"5973","Louisiana Tech","McNeese St",1,1,0.5,2
"5974","Louisiana Tech","Middle Tenn St",0,1,1,1
"5975","Louisiana Tech","Morehead St",0,1,1,1
"5976","Louisiana Tech","NC State",1,0,0,1
"5977","Louisiana Tech","New Mexico St",1,1,0.5,2
"5978","Louisiana Tech","Nicholls St",0,1,1,1
"5979","Louisiana Tech","North Texas",1,1,0.5,2
"5980","Louisiana Tech","Northwestern LA",1,2,0.666666666666667,3
"5981","Louisiana Tech","Oklahoma",0,1,1,1
"5982","Louisiana Tech","Oklahoma St",1,0,0,1
"5983","Louisiana Tech","Old Dominion",1,1,0.5,2
"5984","Louisiana Tech","Presbyterian",0,1,1,1
"5985","Louisiana Tech","Rice",0,4,1,4
"5986","Louisiana Tech","Samford",0,1,1,1
"5987","Louisiana Tech","San Jose St",0,2,1,2
"5988","Louisiana Tech","Seattle",0,2,1,2
"5989","Louisiana Tech","SE Louisiana",0,1,1,1
"5990","Louisiana Tech","SE Missouri St",0,1,1,1
"5991","Louisiana Tech","Southern Miss",1,4,0.8,5
"5992","Louisiana Tech","Southern Univ",0,2,1,2
"5993","Louisiana Tech","St Bonaventure",0,1,1,1
"5994","Louisiana Tech","St Mary's CA",1,0,0,1
"5995","Louisiana Tech","Syracuse",1,0,0,1
"5996","Louisiana Tech","Temple",1,0,0,1
"5997","Louisiana Tech","Texas A&M",1,0,0,1
"5998","Louisiana Tech","Texas St",0,2,1,2
"5999","Louisiana Tech","Troy",0,1,1,1
"6000","Louisiana Tech","Tulane",0,1,1,1
"6001","Louisiana Tech","Tulsa",1,1,0.5,2
"6002","Louisiana Tech","UAB",2,2,0.5,4
"6003","Louisiana Tech","ULL",2,0,0,2
"6004","Louisiana Tech","ULM",0,2,1,2
"6005","Louisiana Tech","UNC Greensboro",0,1,1,1
"6006","Louisiana Tech","Utah St",0,2,1,2
"6007","Louisiana Tech","UT Arlington",0,2,1,2
"6008","Louisiana Tech","UTEP",1,2,0.666666666666667,3
"6009","Louisiana Tech","UT San Antonio",0,5,1,5
"6010","Louisiana Tech","W Kentucky",0,1,1,1
"6011","Louisiana Tech","Centenary",0,1,1,1
"6012","Louisiana Tech","S Arkansas",0,1,1,1
"6013","Louisiana Tech","MTSU",0,2,1,2
"6014","Louisville","Boston College",0,1,1,1
"6015","Louisville","Cincinnati",1,2,0.666666666666667,3
"6016","Louisville","Clemson",0,1,1,1
"6017","Louisville","Cleveland St",0,1,1,1
"6018","Louisville","Col Charleston",0,2,1,2
"6019","Louisville","Connecticut",0,4,1,4
"6020","Louisville","Cornell",0,1,1,1
"6021","Louisville","CS Northridge",0,1,1,1
"6022","Louisville","DePaul",0,1,1,1
"6023","Louisville","Duke",2,0,0,2
"6024","Louisville","Fairfield",0,1,1,1
"6025","Louisville","Florida Intl",0,3,1,3
"6026","Louisville","Florida St",0,1,1,1
"6027","Louisville","Georgetown",1,0,0,1
"6028","Louisville","Georgia Tech",0,1,1,1
"6029","Louisville","Hartford",0,1,1,1
"6030","Louisville","Hofstra",0,1,1,1
"6031","Louisville","Houston",0,3,1,3
"6032","Louisville","Illinois St",0,1,1,1
"6033","Louisville","Indiana",0,1,1,1
"6034","Louisville","Jacksonville St",0,1,1,1
"6035","Louisville","Kentucky",2,1,0.333333333333333,3
"6036","Louisville","Long Beach St",0,1,1,1
"6037","Louisville","Manhattan",0,1,1,1
"6038","Louisville","Marquette",0,1,1,1
"6039","Louisville","Marshall",0,1,1,1
"6040","Louisville","Memphis",2,1,0.333333333333333,3
"6041","Louisville","Miami FL",0,2,1,2
"6042","Louisville","Miami OH",0,1,1,1
"6043","Louisville","Minnesota",0,1,1,1
"6044","Louisville","Missouri",0,1,1,1
"6045","Louisville","Missouri KC",0,2,1,2
"6046","Louisville","Missouri St",0,1,1,1
"6047","Louisville","NC State",1,0,0,1
"6048","Louisville","North Carolina",3,1,0.25,4
"6049","Louisville","Northern Iowa",0,1,1,1
"6050","Louisville","Notre Dame",2,1,0.333333333333333,3
"6051","Louisville","Ohio St",0,1,1,1
"6052","Louisville","Pittsburgh",0,3,1,3
"6053","Louisville","Providence",0,1,1,1
"6054","Louisville","Rutgers",0,4,1,4
"6055","Louisville","Samford",0,1,1,1
"6056","Louisville","Savannah St",0,1,1,1
"6057","Louisville","Seton Hall",0,2,1,2
"6058","Louisville","SMU",0,2,1,2
"6059","Louisville","Southern Miss",0,1,1,1
"6060","Louisville","South Florida",0,4,1,4
"6061","Louisville","St John's",0,1,1,1
"6062","Louisville","Syracuse",2,1,0.333333333333333,3
"6063","Louisville","Temple",0,2,1,2
"6064","Louisville","UCF",0,2,1,2
"6065","Louisville","ULL",0,1,1,1
"6066","Louisville","UNC Wilmington",0,1,1,1
"6067","Louisville","Villanova",1,0,0,1
"6068","Louisville","Virginia",1,1,0.5,2
"6069","Louisville","Virginia Tech",0,1,1,1
"6070","Louisville","Wake Forest",0,1,1,1
"6071","Louisville","W Kentucky",0,3,1,3
"6072","Loy Marymount","Arizona St",1,0,0,1
"6073","Loy Marymount","Boise St",1,0,0,1
"6074","Loy Marymount","BYU",6,1,0.142857142857143,7
"6075","Loy Marymount","Cal Poly SLO",1,1,0.5,2
"6076","Loy Marymount","CS Bakersfield",0,2,1,2
"6077","Loy Marymount","DePaul",0,1,1,1
"6078","Loy Marymount","Gonzaga",6,0,0,6
"6079","Loy Marymount","Long Beach St",1,1,0.5,2
"6080","Loy Marymount","Marist",0,1,1,1
"6081","Loy Marymount","Mississippi",1,0,0,1
"6082","Loy Marymount","Morgan St",0,1,1,1
"6083","Loy Marymount","Nebraska",1,0,0,1
"6084","Loy Marymount","Northern Arizona",1,2,0.666666666666667,3
"6085","Loy Marymount","Northern Iowa",1,0,0,1
"6086","Loy Marymount","Oral Roberts",1,0,0,1
"6087","Loy Marymount","Pacific",2,2,0.5,4
"6088","Loy Marymount","Pepperdine",6,0,0,6
"6089","Loy Marymount","Pittsburgh",1,0,0,1
"6090","Loy Marymount","Portland",5,2,0.285714285714286,7
"6091","Loy Marymount","Portland St",0,1,1,1
"6092","Loy Marymount","San Diego",4,2,0.333333333333333,6
"6093","Loy Marymount","San Francisco",5,1,0.166666666666667,6
"6094","Loy Marymount","Santa Clara",5,2,0.285714285714286,7
"6095","Loy Marymount","S Dakota St",0,1,1,1
"6096","Loy Marymount","SE Missouri St",0,1,1,1
"6097","Loy Marymount","SMU",1,0,0,1
"6098","Loy Marymount","Stanford",1,0,0,1
"6099","Loy Marymount","St Louis",1,0,0,1
"6100","Loy Marymount","St Mary's CA",6,0,0,6
"6101","Loy Marymount","Texas St",0,1,1,1
"6102","Loy Marymount","UC Irvine",1,0,0,1
"6103","Loy Marymount","UC Riverside",0,2,1,2
"6104","Loy Marymount","USC",1,0,0,1
"6105","Loy Marymount","Valparaiso",1,0,0,1
"6106","Loy Marymount","Vanderbilt",1,0,0,1
"6107","Loy Marymount","Wichita St",1,0,0,1
"6108","Loy Marymount","Grand Canyon",0,1,1,1
"6109","Loy Marymount","La Sierra",0,1,1,1
"6110","Loy Marymount","San Diego Chr",0,1,1,1
"6111","Loyola-Chicago","Boise St",0,1,1,1
"6112","Loyola-Chicago","Bradley",2,3,0.6,5
"6113","Loyola-Chicago","Campbell",0,1,1,1
"6114","Loyola-Chicago","Chicago St",0,1,1,1
"6115","Loyola-Chicago","Cleveland St",0,2,1,2
"6116","Loyola-Chicago","DePaul",0,1,1,1
"6117","Loyola-Chicago","Detroit",2,0,0,2
"6118","Loyola-Chicago","Drake",1,3,0.75,4
"6119","Loyola-Chicago","Edwardsville",0,1,1,1
"6120","Loyola-Chicago","Evansville",3,1,0.25,4
"6121","Loyola-Chicago","Fordham",1,0,0,1
"6122","Loyola-Chicago","Furman",0,1,1,1
"6123","Loyola-Chicago","IL Chicago",1,3,0.75,4
"6124","Loyola-Chicago","Illinois St",3,1,0.25,4
"6125","Loyola-Chicago","Indiana St",5,1,0.166666666666667,6
"6126","Loyola-Chicago","Jackson St",0,1,1,1
"6127","Loyola-Chicago","Kent",1,1,0.5,2
"6128","Loyola-Chicago","MD E Shore",0,1,1,1
"6129","Loyola-Chicago","Michigan St",2,0,0,2
"6130","Loyola-Chicago","Mississippi St",1,1,0.5,2
"6131","Loyola-Chicago","Missouri St",1,3,0.75,4
"6132","Loyola-Chicago","N Illinois",1,1,0.5,2
"6133","Loyola-Chicago","Northern Iowa",4,1,0.2,5
"6134","Loyola-Chicago","Portland St",1,0,0,1
"6135","Loyola-Chicago","S Illinois",3,1,0.25,4
"6136","Loyola-Chicago","Southern Utah",0,1,1,1
"6137","Loyola-Chicago","South Florida",1,0,0,1
"6138","Loyola-Chicago","St Peter's",0,1,1,1
"6139","Loyola-Chicago","Tennessee Tech",1,1,0.5,2
"6140","Loyola-Chicago","Texas Tech",0,1,1,1
"6141","Loyola-Chicago","Toledo",0,1,1,1
"6142","Loyola-Chicago","Tulane",2,0,0,2
"6143","Loyola-Chicago","UC Davis",1,0,0,1
"6144","Loyola-Chicago","UT San Antonio",0,1,1,1
"6145","Loyola-Chicago","Valparaiso",1,1,0.5,2
"6146","Loyola-Chicago","Wichita St",4,0,0,4
"6147","Loyola-Chicago","WI Green Bay",2,0,0,2
"6148","Loyola-Chicago","WI Milwaukee",1,2,0.666666666666667,3
"6149","Loyola-Chicago","W Michigan",1,0,0,1
"6150","Loyola-Chicago","Wright St",2,0,0,2
"6151","Loyola-Chicago","Youngstown St",3,0,0,3
"6152","Loyola-Chicago","Abilene Chr",0,1,1,1
"6153","Loyola-Chicago","Rockhurst",0,2,1,2
"6154","Loyola-Chicago","McKendree",0,1,1,1
"6155","Loyola MD","Albany NY",0,1,1,1
"6156","Loyola MD","American Univ",2,2,0.5,4
"6157","Loyola MD","Army",3,1,0.25,4
"6158","Loyola MD","Binghamton",0,2,1,2
"6159","Loyola MD","Boston Univ",3,1,0.25,4
"6160","Loyola MD","Bucknell",5,0,0,5
"6161","Loyola MD","Butler",1,0,0,1
"6162","Loyola MD","Canisius",1,1,0.5,2
"6163","Loyola MD","Colgate",2,2,0.5,4
"6164","Loyola MD","Columbia",0,1,1,1
"6165","Loyola MD","Connecticut",1,0,0,1
"6166","Loyola MD","Coppin St",0,1,1,1
"6167","Loyola MD","Cornell",0,2,1,2
"6168","Loyola MD","Fairfield",0,4,1,4
"6169","Loyola MD","FL Gulf Coast",1,0,0,1
"6170","Loyola MD","Holy Cross",4,1,0.2,5
"6171","Loyola MD","Iona",2,0,0,2
"6172","Loyola MD","Lafayette",3,2,0.4,5
"6173","Loyola MD","Lehigh",2,2,0.5,4
"6174","Loyola MD","Manhattan",0,2,1,2
"6175","Loyola MD","Marist",1,1,0.5,2
"6176","Loyola MD","MD Baltimore Co",0,1,1,1
"6177","Loyola MD","Memphis",1,0,0,1
"6178","Loyola MD","Miami FL",1,0,0,1
"6179","Loyola MD","Mt St Mary's",2,1,0.333333333333333,3
"6180","Loyola MD","Navy",2,2,0.5,4
"6181","Loyola MD","Niagara",1,1,0.5,2
"6182","Loyola MD","Norfolk St",0,1,1,1
"6183","Loyola MD","Rhode Island",0,1,1,1
"6184","Loyola MD","Rider",1,1,0.5,2
"6185","Loyola MD","Siena",1,2,0.666666666666667,3
"6186","Loyola MD","St Joseph's PA",2,0,0,2
"6187","Loyola MD","Stony Brook",2,0,0,2
"6188","Loyola MD","St Peter's",0,2,1,2
"6189","Loyola MD","Syracuse",1,0,0,1
"6190","Loyola MD","Tennessee St",0,1,1,1
"6191","Loyola MD","Texas Tech",1,0,0,1
"6192","Loyola MD","Towson",0,1,1,1
"6193","Loyola MD","Washington",1,0,0,1
"6194","Loyola MD","West Virginia",1,0,0,1
"6195","Loyola MD","Catholic",0,1,1,1
"6196","Loyola MD","UMBC",0,2,1,2
"6197","LSU","Alabama",2,3,0.6,5
"6198","LSU","Arkansas",1,3,0.75,4
"6199","LSU","Auburn",3,2,0.4,5
"6200","LSU","Bethune-Cookman",0,1,1,1
"6201","LSU","Boise St",1,0,0,1
"6202","LSU","Butler",0,1,1,1
"6203","LSU","Chattanooga",0,1,1,1
"6204","LSU","Clemson",1,0,0,1
"6205","LSU","Col Charleston",0,1,1,1
"6206","LSU","Florida",2,2,0.5,4
"6207","LSU","Gardner Webb",0,1,1,1
"6208","LSU","Georgia",3,1,0.25,4
"6209","LSU","Houston Bap",0,1,1,1
"6210","LSU","Kentucky",4,1,0.2,5
"6211","LSU","Marquette",1,0,0,1
"6212","LSU","Massachusetts",1,1,0.5,2
"6213","LSU","McNeese St",0,3,1,3
"6214","LSU","Memphis",1,0,0,1
"6215","LSU","Mississippi",2,2,0.5,4
"6216","LSU","Mississippi St",1,3,0.75,4
"6217","LSU","Missouri",2,2,0.5,4
"6218","LSU","MS Valley St",0,1,1,1
"6219","LSU","New Orleans",0,1,1,1
"6220","LSU","Northwestern LA",0,2,1,2
"6221","LSU","Old Dominion",1,0,0,1
"6222","LSU","Rhode Island",1,0,0,1
"6223","LSU","Sam Houston St",0,1,1,1
"6224","LSU","Santa Barbara",0,1,1,1
"6225","LSU","Savannah St",0,1,1,1
"6226","LSU","SE Louisiana",0,1,1,1
"6227","LSU","Seton Hall",0,1,1,1
"6228","LSU","South Carolina",1,3,0.75,4
"6229","LSU","Southern Miss",0,1,1,1
"6230","LSU","St Joseph's PA",0,1,1,1
"6231","LSU","Tennessee",3,1,0.25,4
"6232","LSU","Texas A&M",3,3,0.5,6
"6233","LSU","Texas Tech",0,2,1,2
"6234","LSU","UAB",0,2,1,2
"6235","LSU","UC Irvine",0,1,1,1
"6236","LSU","ULM",0,1,1,1
"6237","LSU","Vanderbilt",0,4,1,4
"6238","LSU","Weber St",0,1,1,1
"6239","LSU","West Virginia",0,1,1,1
"6240","Maine","Albany NY",7,1,0.125,8
"6241","Maine","Army",3,0,0,3
"6242","Maine","Binghamton",3,3,0.5,6
"6243","Maine","Boston College",1,0,0,1
"6244","Maine","Boston Univ",1,1,0.5,2
"6245","Maine","Brown",1,0,0,1
"6246","Maine","Butler",1,0,0,1
"6247","Maine","Chattanooga",1,0,0,1
"6248","Maine","C Michigan",1,0,0,1
"6249","Maine","Connecticut",1,0,0,1
"6250","Maine","Dartmouth",3,0,0,3
"6251","Maine","Duquesne",1,0,0,1
"6252","Maine","FL Gulf Coast",0,1,1,1
"6253","Maine","Florida St",1,0,0,1
"6254","Maine","G Washington",1,0,0,1
"6255","Maine","Hartford",4,2,0.333333333333333,6
"6256","Maine","Holy Cross",1,0,0,1
"6257","Maine","Long Island",1,0,0,1
"6258","Maine","Marist",1,0,0,1
"6259","Maine","MD Baltimore Co",1,1,0.5,2
"6260","Maine","Middle Tenn St",0,1,1,1
"6261","Maine","New Hampshire",4,2,0.333333333333333,6
"6262","Maine","N Illinois",1,0,0,1
"6263","Maine","NJIT",4,0,0,4
"6264","Maine","Northeastern",0,1,1,1
"6265","Maine","Providence",1,0,0,1
"6266","Maine","Quinnipiac",2,1,0.333333333333333,3
"6267","Maine","Rhode Island",1,0,0,1
"6268","Maine","Seton Hall",2,0,0,2
"6269","Maine","Siena",0,1,1,1
"6270","Maine","Stony Brook",7,0,0,7
"6271","Maine","Valparaiso",1,0,0,1
"6272","Maine","Vermont",5,1,0.166666666666667,6
"6273","Maine","Wagner",0,1,1,1
"6274","Maine","Fisher",0,1,1,1
"6275","Maine","MA Lowell",4,0,0,4
"6276","Maine","UMBC",3,1,0.25,4
"6277","Manhattan","Binghamton",0,1,1,1
"6278","Manhattan","Buffalo",0,2,1,2
"6279","Manhattan","Canisius",1,5,0.833333333333333,6
"6280","Manhattan","Columbia",1,1,0.5,2
"6281","Manhattan","Dayton",1,0,0,1
"6282","Manhattan","Fairfield",2,4,0.666666666666667,6
"6283","Manhattan","Florida St",1,0,0,1
"6284","Manhattan","Fordham",1,2,0.666666666666667,3
"6285","Manhattan","George Mason",1,0,0,1
"6286","Manhattan","G Washington",2,0,0,2
"6287","Manhattan","Harvard",1,0,0,1
"6288","Manhattan","Hofstra",0,2,1,2
"6289","Manhattan","Illinois St",0,1,1,1
"6290","Manhattan","Iona",4,4,0.5,8
"6291","Manhattan","La Salle",0,1,1,1
"6292","Manhattan","Long Island",1,0,0,1
"6293","Manhattan","Louisville",1,0,0,1
"6294","Manhattan","Loyola MD",2,0,0,2
"6295","Manhattan","Marist",1,6,0.857142857142857,7
"6296","Manhattan","Massachusetts",1,0,0,1
"6297","Manhattan","Monmouth NJ",0,4,1,4
"6298","Manhattan","Morgan St",0,1,1,1
"6299","Manhattan","Niagara",3,3,0.5,6
"6300","Manhattan","Northeastern",1,0,0,1
"6301","Manhattan","Pittsburgh",1,0,0,1
"6302","Manhattan","Quinnipiac",3,2,0.4,5
"6303","Manhattan","Rider",3,3,0.5,6
"6304","Manhattan","Rutgers",1,0,0,1
"6305","Manhattan","Siena",2,4,0.666666666666667,6
"6306","Manhattan","South Carolina",1,1,0.5,2
"6307","Manhattan","Stony Brook",1,0,0,1
"6308","Manhattan","St Peter's",0,8,1,8
"6309","Manhattan","UNC Wilmington",0,1,1,1
"6310","Marist","Army",2,0,0,2
"6311","Marist","Boston College",1,0,0,1
"6312","Marist","Bucknell",2,1,0.333333333333333,3
"6313","Marist","Canisius",4,2,0.333333333333333,6
"6314","Marist","Clemson",1,0,0,1
"6315","Marist","Col Charleston",1,1,0.5,2
"6316","Marist","Colgate",1,0,0,1
"6317","Marist","Columbia",0,1,1,1
"6318","Marist","Elon",2,0,0,2
"6319","Marist","Fairfield",3,3,0.5,6
"6320","Marist","FL Gulf Coast",1,0,0,1
"6321","Marist","Fresno St",0,1,1,1
"6322","Marist","Hartford",1,0,0,1
"6323","Marist","Hawaii",1,0,0,1
"6324","Marist","Iona",5,1,0.166666666666667,6
"6325","Marist","Loy Marymount",1,0,0,1
"6326","Marist","Loyola MD",1,1,0.5,2
"6327","Marist","Maine",0,1,1,1
"6328","Marist","Manhattan",6,1,0.142857142857143,7
"6329","Marist","Maryland",1,0,0,1
"6330","Marist","Monmouth NJ",2,2,0.5,4
"6331","Marist","Morgan St",1,0,0,1
"6332","Marist","Niagara",4,3,0.428571428571429,7
"6333","Marist","Penn",1,1,0.5,2
"6334","Marist","Providence",1,0,0,1
"6335","Marist","Quinnipiac",3,2,0.4,5
"6336","Marist","Rider",5,1,0.166666666666667,6
"6337","Marist","Siena",4,2,0.333333333333333,6
"6338","Marist","St Joseph's PA",2,0,0,2
"6339","Marist","Stony Brook",2,0,0,2
"6340","Marist","St Peter's",3,3,0.5,6
"6341","Marist","Vanderbilt",0,1,1,1
"6342","Marist","VMI",1,1,0.5,2
"6343","Marist","West Virginia",1,0,0,1
"6344","Marquette","Alabama A&M",0,1,1,1
"6345","Marquette","Arizona St",1,1,0.5,2
"6346","Marquette","Ball St",0,1,1,1
"6347","Marquette","Butler",4,1,0.2,5
"6348","Marquette","Cincinnati",1,0,0,1
"6349","Marquette","Colgate",0,1,1,1
"6350","Marquette","Connecticut",0,1,1,1
"6351","Marquette","Creighton",3,1,0.25,4
"6352","Marquette","CS Fullerton",0,1,1,1
"6353","Marquette","DePaul",1,4,0.8,5
"6354","Marquette","Florida",1,0,0,1
"6355","Marquette","Georgetown",3,3,0.5,6
"6356","Marquette","Georgia Tech",0,1,1,1
"6357","Marquette","Grambling",0,1,1,1
"6358","Marquette","G Washington",0,1,1,1
"6359","Marquette","IUPUI",0,1,1,1
"6360","Marquette","Louisville",1,0,0,1
"6361","Marquette","LSU",0,1,1,1
"6362","Marquette","MD Baltimore Co",0,1,1,1
"6363","Marquette","Michigan St",1,0,0,1
"6364","Marquette","Mississippi St",0,1,1,1
"6365","Marquette","Morgan St",0,1,1,1
"6366","Marquette","NC Central",0,1,1,1
"6367","Marquette","NE Omaha",1,0,0,1
"6368","Marquette","New Hampshire",0,1,1,1
"6369","Marquette","New Mexico",1,0,0,1
"6370","Marquette","NJIT",0,1,1,1
"6371","Marquette","North Dakota",0,1,1,1
"6372","Marquette","Notre Dame",0,1,1,1
"6373","Marquette","Ohio St",2,0,0,2
"6374","Marquette","Pittsburgh",0,2,1,2
"6375","Marquette","Providence",2,3,0.6,5
"6376","Marquette","Rutgers",0,1,1,1
"6377","Marquette","Samford",0,1,1,1
"6378","Marquette","San Diego St",1,0,0,1
"6379","Marquette","Savannah St",0,1,1,1
"6380","Marquette","SE Louisiana",0,1,1,1
"6381","Marquette","Seton Hall",1,6,0.857142857142857,7
"6382","Marquette","Southern Univ",0,1,1,1
"6383","Marquette","South Florida",0,2,1,2
"6384","Marquette","St John's",4,1,0.2,5
"6385","Marquette","Syracuse",0,1,1,1
"6386","Marquette","Tennessee",0,1,1,1
"6387","Marquette","TN Martin",0,1,1,1
"6388","Marquette","USC",0,1,1,1
"6389","Marquette","Villanova",6,0,0,6
"6390","Marquette","WI Green Bay",1,0,0,1
"6391","Marquette","Wisconsin",2,1,0.333333333333333,3
"6392","Marquette","Xavier",4,1,0.2,5
"6393","Marshall","Akron",2,0,0,2
"6394","Marshall","Arkansas St",2,0,0,2
"6395","Marshall","Charlotte",3,1,0.25,4
"6396","Marshall","Cincinnati",1,0,0,1
"6397","Marshall","Cleveland St",1,0,0,1
"6398","Marshall","Coppin St",0,1,1,1
"6399","Marshall","Delaware St",1,0,0,1
"6400","Marshall","East Carolina",1,2,0.666666666666667,3
"6401","Marshall","ETSU",1,0,0,1
"6402","Marshall","FL Atlantic",2,2,0.5,4
"6403","Marshall","Florida Intl",1,2,0.666666666666667,3
"6404","Marshall","Hofstra",1,0,0,1
"6405","Marshall","Houston",1,0,0,1
"6406","Marshall","Jacksonville St",0,1,1,1
"6407","Marshall","Kentucky",1,0,0,1
"6408","Marshall","Longwood",0,1,1,1
"6409","Marshall","Louisiana Tech",2,0,0,2
"6410","Marshall","Louisville",1,0,0,1
"6411","Marshall","Memphis",2,0,0,2
"6412","Marshall","Middle Tenn St",1,0,0,1
"6413","Marshall","Morehead St",2,1,0.333333333333333,3
"6414","Marshall","Nevada",1,1,0.5,2
"6415","Marshall","North Texas",1,1,0.5,2
"6416","Marshall","Ohio",1,0,0,1
"6417","Marshall","Old Dominion",4,0,0,4
"6418","Marshall","Penn St",2,0,0,2
"6419","Marshall","Presbyterian",0,1,1,1
"6420","Marshall","Rice",0,3,1,3
"6421","Marshall","Savannah St",0,2,1,2
"6422","Marshall","S Carolina St",0,1,1,1
"6423","Marshall","S Dakota St",1,0,0,1
"6424","Marshall","SF Austin",1,0,0,1
"6425","Marshall","SMU",1,0,0,1
"6426","Marshall","South Carolina",2,0,0,2
"6427","Marshall","Southern Miss",2,3,0.6,5
"6428","Marshall","Tulane",2,0,0,2
"6429","Marshall","Tulsa",1,1,0.5,2
"6430","Marshall","UAB",4,0,0,4
"6431","Marshall","UCF",0,2,1,2
"6432","Marshall","UNC Wilmington",0,2,1,2
"6433","Marshall","UTEP",2,1,0.333333333333333,3
"6434","Marshall","UT San Antonio",2,0,0,2
"6435","Marshall","Vanderbilt",1,0,0,1
"6436","Marshall","Villanova",1,0,0,1
"6437","Marshall","West Virginia",3,0,0,3
"6438","Marshall","W Kentucky",2,2,0.5,4
"6439","Marshall","Alice Lloyd",0,1,1,1
"6440","Marshall","Rio Grande",0,1,1,1
"6441","Marshall","WV Tech",0,1,1,1
"6442","Marshall","King TN",0,1,1,1
"6443","Marshall","MTSU",1,0,0,1
"6444","Maryland","Arizona St",0,1,1,1
"6445","Maryland","Boston College",1,2,0.666666666666667,3
"6446","Maryland","Boston Univ",1,0,0,1
"6447","Maryland","Central Conn",0,1,1,1
"6448","Maryland","Clemson",1,1,0.5,2
"6449","Maryland","Connecticut",1,0,0,1
"6450","Maryland","Delaware St",0,1,1,1
"6451","Maryland","Duke",2,1,0.333333333333333,3
"6452","Maryland","FL Atlantic",0,1,1,1
"6453","Maryland","Florida St",4,1,0.2,5
"6454","Maryland","Fordham",0,1,1,1
"6455","Maryland","Ga Southern",0,1,1,1
"6456","Maryland","George Mason",0,1,1,1
"6457","Maryland","Georgia Tech",1,1,0.5,2
"6458","Maryland","G Washington",1,0,0,1
"6459","Maryland","Illinois",1,0,0,1
"6460","Maryland","Indiana",1,2,0.666666666666667,3
"6461","Maryland","Iowa",1,0,0,1
"6462","Maryland","Iowa St",0,1,1,1
"6463","Maryland","IUPUI",0,1,1,1
"6464","Maryland","Kentucky",1,0,0,1
"6465","Maryland","Lafayette",0,1,1,1
"6466","Maryland","Long Island",0,1,1,1
"6467","Maryland","Marist",0,1,1,1
"6468","Maryland","MD E Shore",0,1,1,1
"6469","Maryland","Miami FL",1,1,0.5,2
"6470","Maryland","Michigan",0,1,1,1
"6471","Maryland","Michigan St",1,2,0.666666666666667,3
"6472","Maryland","Minnesota",0,1,1,1
"6473","Maryland","Monmouth NJ",0,2,1,2
"6474","Maryland","Morehead St",0,1,1,1
"6475","Maryland","Morgan St",0,1,1,1
"6476","Maryland","NC Central",0,2,1,2
"6477","Maryland","NC State",1,1,0.5,2
"6478","Maryland","Nebraska",0,2,1,2
"6479","Maryland","North Carolina",3,0,0,3
"6480","Maryland","Northern Iowa",0,1,1,1
"6481","Maryland","Northwestern",0,2,1,2
"6482","Maryland","Notre Dame",0,1,1,1
"6483","Maryland","Oakland",0,1,1,1
"6484","Maryland","Ohio St",2,0,0,2
"6485","Maryland","Oklahoma St",0,1,1,1
"6486","Maryland","Oregon St",1,0,0,1
"6487","Maryland","Penn St",0,2,1,2
"6488","Maryland","Pittsburgh",2,0,0,2
"6489","Maryland","Providence",0,1,1,1
"6490","Maryland","Purdue",0,1,1,1
"6491","Maryland","Rutgers",0,2,1,2
"6492","Maryland","S Carolina St",0,1,1,1
"6493","Maryland","SC Upstate",0,1,1,1
"6494","Maryland","Stony Brook",0,1,1,1
"6495","Maryland","Syracuse",1,0,0,1
"6496","Maryland","Tulsa",0,1,1,1
"6497","Maryland","Virginia",4,1,0.2,5
"6498","Maryland","Virginia Tech",0,4,1,4
"6499","Maryland","VMI",0,1,1,1
"6500","Maryland","Wagner",0,1,1,1
"6501","Maryland","Wake Forest",0,3,1,3
"6502","Maryland","Winthrop",0,1,1,1
"6503","Maryland","Wisconsin",0,1,1,1
"6504","Maryland","Abilene Chr",0,1,1,1
"6505","Massachusetts","Boston College",0,2,1,2
"6506","Massachusetts","Butler",1,0,0,1
"6507","Massachusetts","BYU",1,1,0.5,2
"6508","Massachusetts","Canisius",0,1,1,1
"6509","Massachusetts","Charlotte",1,0,0,1
"6510","Massachusetts","Clemson",0,1,1,1
"6511","Massachusetts","Davidson",1,0,0,1
"6512","Massachusetts","Dayton",1,2,0.666666666666667,3
"6513","Massachusetts","Duquesne",0,3,1,3
"6514","Massachusetts","East Carolina",0,1,1,1
"6515","Massachusetts","Elon",0,2,1,2
"6516","Massachusetts","E Michigan",0,2,1,2
"6517","Massachusetts","FL Gulf Coast",1,0,0,1
"6518","Massachusetts","Florida St",1,1,0.5,2
"6519","Massachusetts","Fordham",0,4,1,4
"6520","Massachusetts","George Mason",1,2,0.666666666666667,3
"6521","Massachusetts","G Washington",3,1,0.25,4
"6522","Massachusetts","Harvard",1,1,0.5,2
"6523","Massachusetts","Iona",0,1,1,1
"6524","Massachusetts","La Salle",1,4,0.8,5
"6525","Massachusetts","LSU",1,1,0.5,2
"6526","Massachusetts","Manhattan",0,1,1,1
"6527","Massachusetts","Miami FL",1,0,0,1
"6528","Massachusetts","Miami OH",0,2,1,2
"6529","Massachusetts","NC State",1,0,0,1
"6530","Massachusetts","Nebraska",0,1,1,1
"6531","Massachusetts","New Mexico",0,1,1,1
"6532","Massachusetts","N Illinois",0,2,1,2
"6533","Massachusetts","Northeastern",0,2,1,2
"6534","Massachusetts","Notre Dame",1,0,0,1
"6535","Massachusetts","Ohio",0,2,1,2
"6536","Massachusetts","Providence",1,2,0.666666666666667,3
"6537","Massachusetts","Rhode Island",1,6,0.857142857142857,7
"6538","Massachusetts","Richmond",2,1,0.333333333333333,3
"6539","Massachusetts","Siena",0,2,1,2
"6540","Massachusetts","St Bonaventure",3,2,0.4,5
"6541","Massachusetts","St Joseph's PA",3,2,0.4,5
"6542","Massachusetts","St Louis",2,1,0.333333333333333,3
"6543","Massachusetts","Temple",1,0,0,1
"6544","Massachusetts","Tennessee",1,0,0,1
"6545","Massachusetts","VA Commonwealth",2,1,0.333333333333333,3
"6546","Massachusetts","Xavier",0,1,1,1
"6547","Massachusetts","Youngstown St",0,1,1,1
"6548","McNeese St","Baylor",1,0,0,1
"6549","McNeese St","Cent Arkansas",3,2,0.4,5
"6550","McNeese St","C Michigan",1,0,0,1
"6551","McNeese St","East Carolina",1,0,0,1
"6552","McNeese St","Georgia St",1,0,0,1
"6553","McNeese St","Houston Bap",1,2,0.666666666666667,3
"6554","McNeese St","Lamar",1,4,0.8,5
"6555","McNeese St","Louisiana Tech",1,1,0.5,2
"6556","McNeese St","LSU",3,0,0,3
"6557","McNeese St","Michigan St",1,0,0,1
"6558","McNeese St","Mississippi",1,0,0,1
"6559","McNeese St","Mississippi St",0,1,1,1
"6560","McNeese St","New Orleans",1,3,0.75,4
"6561","McNeese St","Nicholls St",4,2,0.333333333333333,6
"6562","McNeese St","North Carolina",1,0,0,1
"6563","McNeese St","Northwestern LA",6,0,0,6
"6564","McNeese St","Oral Roberts",2,2,0.5,4
"6565","McNeese St","Rhode Island",1,0,0,1
"6566","McNeese St","Sam Houston St",3,1,0.25,4
"6567","McNeese St","San Diego St",1,0,0,1
"6568","McNeese St","SE Louisiana",2,5,0.714285714285714,7
"6569","McNeese St","SE Missouri St",1,0,0,1
"6570","McNeese St","SF Austin",4,0,0,4
"6571","McNeese St","SMU",1,0,0,1
"6572","McNeese St","TAM C. Christi",4,1,0.2,5
"6573","McNeese St","TCU",1,0,0,1
"6574","McNeese St","Texas A&M",1,0,0,1
"6575","McNeese St","Texas Tech",0,1,1,1
"6576","McNeese St","Toledo",2,0,0,2
"6577","McNeese St","ULL",1,2,0.666666666666667,3
"6578","McNeese St","Abilene Chr",0,2,1,2
"6579","McNeese St","Incarnate Word",1,1,0.5,2
"6580","McNeese St","Jarvis Chr",0,1,1,1
"6581","McNeese St","Louisiana Col",0,2,1,2
"6582","McNeese St","Stillman",0,1,1,1
"6583","McNeese St","LSU-Alexandria",0,1,1,1
"6584","McNeese St","Southern N.O.",0,1,1,1
"6585","MD Baltimore Co","Albany NY",2,0,0,2
"6586","MD Baltimore Co","American Univ",1,0,0,1
"6587","MD Baltimore Co","Binghamton",0,2,1,2
"6588","MD Baltimore Co","Boston Univ",2,0,0,2
"6589","MD Baltimore Co","Canisius",1,0,0,1
"6590","MD Baltimore Co","Central Conn",1,0,0,1
"6591","MD Baltimore Co","Coppin St",1,0,0,1
"6592","MD Baltimore Co","DePaul",1,0,0,1
"6593","MD Baltimore Co","George Mason",1,0,0,1
"6594","MD Baltimore Co","Hartford",1,1,0.5,2
"6595","MD Baltimore Co","Loyola MD",1,0,0,1
"6596","MD Baltimore Co","Maine",1,1,0.5,2
"6597","MD Baltimore Co","Marquette",1,0,0,1
"6598","MD Baltimore Co","Mt St Mary's",1,0,0,1
"6599","MD Baltimore Co","New Hampshire",1,1,0.5,2
"6600","MD Baltimore Co","Norfolk St",1,0,0,1
"6601","MD Baltimore Co","Penn",1,0,0,1
"6602","MD Baltimore Co","Stony Brook",2,0,0,2
"6603","MD Baltimore Co","Towson",0,1,1,1
"6604","MD Baltimore Co","Vermont",2,0,0,2
"6605","MD E Shore","American Univ",2,0,0,2
"6606","MD E Shore","Ark Pine Bluff",1,0,0,1
"6607","MD E Shore","Bethune-Cookman",2,1,0.333333333333333,3
"6608","MD E Shore","Bucknell",1,0,0,1
"6609","MD E Shore","Cincinnati",1,0,0,1
"6610","MD E Shore","Columbia",1,0,0,1
"6611","MD E Shore","Connecticut",1,0,0,1
"6612","MD E Shore","Coppin St",2,3,0.6,5
"6613","MD E Shore","Delaware St",3,3,0.5,6
"6614","MD E Shore","Detroit",1,0,0,1
"6615","MD E Shore","Duquesne",0,1,1,1
"6616","MD E Shore","Florida A&M",1,1,0.5,2
"6617","MD E Shore","Fordham",0,1,1,1
"6618","MD E Shore","Hampton",5,0,0,5
"6619","MD E Shore","Hawaii",1,0,0,1
"6620","MD E Shore","Houston Bap",1,0,0,1
"6621","MD E Shore","Howard",4,2,0.333333333333333,6
"6622","MD E Shore","Iowa",1,0,0,1
"6623","MD E Shore","Loyola-Chicago",1,0,0,1
"6624","MD E Shore","Maryland",1,0,0,1
"6625","MD E Shore","Mississippi St",1,0,0,1
"6626","MD E Shore","Morgan St",3,2,0.4,5
"6627","MD E Shore","Mt St Mary's",0,2,1,2
"6628","MD E Shore","Navy",1,1,0.5,2
"6629","MD E Shore","NC A&T",1,2,0.666666666666667,3
"6630","MD E Shore","NC Central",3,0,0,3
"6631","MD E Shore","NJIT",2,0,0,2
"6632","MD E Shore","Norfolk St",5,1,0.166666666666667,6
"6633","MD E Shore","Ohio",1,0,0,1
"6634","MD E Shore","Old Dominion",1,0,0,1
"6635","MD E Shore","Oregon St",1,0,0,1
"6636","MD E Shore","Purdue",1,0,0,1
"6637","MD E Shore","Savannah St",2,1,0.333333333333333,3
"6638","MD E Shore","S Carolina St",2,1,0.333333333333333,3
"6639","MD E Shore","South Florida",1,0,0,1
"6640","MD E Shore","St Bonaventure",0,1,1,1
"6641","MD E Shore","St Francis PA",1,0,0,1
"6642","MD E Shore","TN Martin",0,1,1,1
"6643","MD E Shore","VA Commonwealth",1,0,0,1
"6644","MD E Shore","Villanova",1,0,0,1
"6645","MD E Shore","Virginia Tech",2,0,0,2
"6646","MD E Shore","W Michigan",1,0,0,1
"6647","MD E Shore","Salisbury St",0,1,1,1
"6648","MD E Shore","UMBC",1,1,0.5,2
"6649","MD E Shore","Wilmington DE",1,0,0,1
"6650","Memphis","Ark Little Rock",0,1,1,1
"6651","Memphis","Austin Peay",0,2,1,2
"6652","Memphis","Baylor",1,0,0,1
"6653","Memphis","Bradley",0,1,1,1
"6654","Memphis","Cincinnati",3,1,0.25,4
"6655","Memphis","Connecticut",3,2,0.4,5
"6656","Memphis","East Carolina",1,3,0.75,4
"6657","Memphis","Florida",1,0,0,1
"6658","Memphis","Gonzaga",1,1,0.5,2
"6659","Memphis","Harvard",0,1,1,1
"6660","Memphis","Houston",1,4,0.8,5
"6661","Memphis","Indiana St",0,1,1,1
"6662","Memphis","Jackson St",0,1,1,1
"6663","Memphis","Jacksonville St",0,1,1,1
"6664","Memphis","Lipscomb",0,1,1,1
"6665","Memphis","Louisville",1,2,0.666666666666667,3
"6666","Memphis","Loyola MD",0,1,1,1
"6667","Memphis","LSU",0,1,1,1
"6668","Memphis","Marshall",0,2,1,2
"6669","Memphis","Minnesota",1,0,0,1
"6670","Memphis","NC Central",0,1,1,1
"6671","Memphis","Nicholls St",0,1,1,1
"6672","Memphis","Northern Iowa",0,1,1,1
"6673","Memphis","North Florida",0,1,1,1
"6674","Memphis","Northwestern LA",0,1,1,1
"6675","Memphis","Ohio",0,1,1,1
"6676","Memphis","Oklahoma St",2,1,0.333333333333333,3
"6677","Memphis","Oral Roberts",0,2,1,2
"6678","Memphis","Prairie View",0,1,1,1
"6679","Memphis","Rice",0,1,1,1
"6680","Memphis","Rutgers",0,2,1,2
"6681","Memphis","Samford",0,1,1,1
"6682","Memphis","SC Upstate",0,1,1,1
"6683","Memphis","SE Missouri St",0,1,1,1
"6684","Memphis","SF Austin",1,0,0,1
"6685","Memphis","Siena",0,1,1,1
"6686","Memphis","SMU",3,2,0.4,5
"6687","Memphis","Southern Miss",0,2,1,2
"6688","Memphis","South Florida",0,3,1,3
"6689","Memphis","Temple",2,2,0.5,4
"6690","Memphis","Tennessee",0,1,1,1
"6691","Memphis","TN Martin",0,1,1,1
"6692","Memphis","Tulane",1,2,0.666666666666667,3
"6693","Memphis","Tulsa",2,1,0.333333333333333,3
"6694","Memphis","UAB",0,2,1,2
"6695","Memphis","UCF",0,6,1,6
"6696","Memphis","UTEP",0,1,1,1
"6697","Memphis","VA Commonwealth",1,0,0,1
"6698","Memphis","Wichita St",1,0,0,1
"6699","Memphis","W Illinois",0,1,1,1
"6700","Memphis","Xavier",1,0,0,1
"6701","Memphis","LeMoyne-Owen",0,1,1,1
"6702","Mercer","Alabama",0,1,1,1
"6703","Mercer","Alabama A&M",0,1,1,1
"6704","Mercer","Alcorn St",0,1,1,1
"6705","Mercer","Bethune-Cookman",0,1,1,1
"6706","Mercer","Chattanooga",1,2,0.666666666666667,3
"6707","Mercer","Citadel",0,2,1,2
"6708","Mercer","Colorado St",1,0,0,1
"6709","Mercer","Dartmouth",1,0,0,1
"6710","Mercer","Denver",1,1,0.5,2
"6711","Mercer","ETSU",1,5,0.833333333333333,6
"6712","Mercer","Evansville",1,0,0,1
"6713","Mercer","FL Gulf Coast",3,3,0.5,6
"6714","Mercer","Florida St",0,1,1,1
"6715","Mercer","Furman",1,3,0.75,4
"6716","Mercer","George Mason",1,0,0,1
"6717","Mercer","Georgia",2,0,0,2
"6718","Mercer","IL Chicago",1,0,0,1
"6719","Mercer","Jacksonville",1,4,0.8,5
"6720","Mercer","Kennesaw",1,4,0.8,5
"6721","Mercer","Lipscomb",0,5,1,5
"6722","Mercer","Mississippi",0,1,1,1
"6723","Mercer","New Mexico",1,0,0,1
"6724","Mercer","N Kentucky",1,3,0.75,4
"6725","Mercer","North Florida",2,2,0.5,4
"6726","Mercer","Ohio",1,0,0,1
"6727","Mercer","Oklahoma",1,0,0,1
"6728","Mercer","Pacific",1,0,0,1
"6729","Mercer","Rice",0,1,1,1
"6730","Mercer","Samford",0,2,1,2
"6731","Mercer","Santa Barbara",1,0,0,1
"6732","Mercer","SC Upstate",1,5,0.833333333333333,6
"6733","Mercer","Seton Hall",1,1,0.5,2
"6734","Mercer","Stetson",0,4,1,4
"6735","Mercer","Tennessee",1,0,0,1
"6736","Mercer","Texas",1,0,0,1
"6737","Mercer","Texas A&M",1,0,0,1
"6738","Mercer","UNC Greensboro",0,2,1,2
"6739","Mercer","Valparaiso",0,1,1,1
"6740","Mercer","VMI",0,3,1,3
"6741","Mercer","Wake Forest",1,0,0,1
"6742","Mercer","W Carolina",2,0,0,2
"6743","Mercer","Wofford",2,0,0,2
"6744","Mercer","Yale",0,1,1,1
"6745","Mercer","J&W NC",0,1,1,1
"6746","Mercer","Reinhardt",0,1,1,1
"6747","Mercer","St Andrew's",0,2,1,2
"6748","Mercer","Piedmont",0,1,1,1
"6749","Miami FL","Akron",0,1,1,1
"6750","Miami FL","Arizona",1,0,0,1
"6751","Miami FL","Arizona St",0,1,1,1
"6752","Miami FL","Boston College",0,5,1,5
"6753","Miami FL","Charlotte",0,3,1,3
"6754","Miami FL","Clemson",1,3,0.75,4
"6755","Miami FL","Col Charleston",0,2,1,2
"6756","Miami FL","CS Fullerton",0,1,1,1
"6757","Miami FL","Detroit",0,1,1,1
"6758","Miami FL","Drexel",0,1,1,1
"6759","Miami FL","Duke",2,2,0.5,4
"6760","Miami FL","E Kentucky",1,0,0,1
"6761","Miami FL","FL Gulf Coast",1,0,0,1
"6762","Miami FL","Florida",0,1,1,1
"6763","Miami FL","Florida St",2,4,0.666666666666667,6
"6764","Miami FL","Ga Southern",0,1,1,1
"6765","Miami FL","Georgia Tech",2,2,0.5,4
"6766","Miami FL","G Washington",1,0,0,1
"6767","Miami FL","Hawaii",0,1,1,1
"6768","Miami FL","Howard",0,1,1,1
"6769","Miami FL","Illinois",0,1,1,1
"6770","Miami FL","Indiana St",1,0,0,1
"6771","Miami FL","Jacksonville",0,1,1,1
"6772","Miami FL","La Salle",0,2,1,2
"6773","Miami FL","Louisville",2,0,0,2
"6774","Miami FL","Loyola MD",0,1,1,1
"6775","Miami FL","Maryland",1,1,0.5,2
"6776","Miami FL","Massachusetts",0,1,1,1
"6777","Miami FL","Michigan St",0,1,1,1
"6778","Miami FL","NC State",2,3,0.6,5
"6779","Miami FL","Nebraska",1,0,0,1
"6780","Miami FL","Norfolk St",0,1,1,1
"6781","Miami FL","North Carolina",1,3,0.75,4
"6782","Miami FL","Notre Dame",2,1,0.333333333333333,3
"6783","Miami FL","Pittsburgh",1,1,0.5,2
"6784","Miami FL","Providence",1,0,0,1
"6785","Miami FL","Savannah St",0,2,1,2
"6786","Miami FL","South Alabama",0,1,1,1
"6787","Miami FL","Stetson",0,1,1,1
"6788","Miami FL","St Francis NY",1,0,0,1
"6789","Miami FL","Syracuse",2,1,0.333333333333333,3
"6790","Miami FL","TX Southern",0,1,1,1
"6791","Miami FL","UCF",1,1,0.5,2
"6792","Miami FL","Virginia",2,1,0.333333333333333,3
"6793","Miami FL","Virginia Tech",2,6,0.75,8
"6794","Miami FL","Wake Forest",2,1,0.333333333333333,3
"6795","Miami FL","WI Green Bay",1,0,0,1
"6796","Miami OH","Akron",3,3,0.5,6
"6797","Miami OH","Arizona St",1,0,0,1
"6798","Miami OH","Ball St",1,2,0.666666666666667,3
"6799","Miami OH","Bowling Green",2,4,0.666666666666667,6
"6800","Miami OH","Buffalo",5,1,0.166666666666667,6
"6801","Miami OH","C Michigan",1,3,0.75,4
"6802","Miami OH","Dayton",2,0,0,2
"6803","Miami OH","Elon",1,0,0,1
"6804","Miami OH","E Michigan",3,2,0.4,5
"6805","Miami OH","Evansville",3,0,0,3
"6806","Miami OH","Grambling",0,1,1,1
"6807","Miami OH","IL Chicago",0,1,1,1
"6808","Miami OH","IPFW",2,1,0.333333333333333,3
"6809","Miami OH","James Madison",0,1,1,1
"6810","Miami OH","Kent",4,3,0.428571428571429,7
"6811","Miami OH","Liberty",0,1,1,1
"6812","Miami OH","Longwood",0,1,1,1
"6813","Miami OH","Louisville",1,0,0,1
"6814","Miami OH","Massachusetts",2,0,0,2
"6815","Miami OH","Missouri KC",1,1,0.5,2
"6816","Miami OH","NC State",1,0,0,1
"6817","Miami OH","N Illinois",3,1,0.25,4
"6818","Miami OH","Northwestern",1,0,0,1
"6819","Miami OH","Notre Dame",1,0,0,1
"6820","Miami OH","Ohio",6,1,0.142857142857143,7
"6821","Miami OH","Ohio St",1,0,0,1
"6822","Miami OH","S Illinois",1,1,0.5,2
"6823","Miami OH","Southern Utah",0,1,1,1
"6824","Miami OH","Tennessee St",0,1,1,1
"6825","Miami OH","Toledo",3,0,0,3
"6826","Miami OH","Virginia Tech",1,0,0,1
"6827","Miami OH","William & Mary",0,1,1,1
"6828","Miami OH","W Michigan",4,0,0,4
"6829","Miami OH","Wright St",2,1,0.333333333333333,3
"6830","Miami OH","Xavier",1,0,0,1
"6831","Miami OH","Wilmington OH",1,0,0,1
"6832","Miami OH","Capital",0,1,1,1
"6833","Michigan","Arizona",2,0,0,2
"6834","Michigan","Arkansas",0,1,1,1
"6835","Michigan","Binghamton",0,1,1,1
"6836","Michigan","Bradley",0,1,1,1
"6837","Michigan","Bucknell",0,1,1,1
"6838","Michigan","Charlotte",1,0,0,1
"6839","Michigan","Cleveland St",0,1,1,1
"6840","Michigan","C Michigan",0,1,1,1
"6841","Michigan","Coppin St",0,2,1,2
"6842","Michigan","Detroit",0,1,1,1
"6843","Michigan","Duke",1,0,0,1
"6844","Michigan","E Michigan",1,1,0.5,2
"6845","Michigan","Florida St",0,1,1,1
"6846","Michigan","Holy Cross",0,1,1,1
"6847","Michigan","Houston Bap",0,1,1,1
"6848","Michigan","Illinois",1,6,0.857142857142857,7
"6849","Michigan","Indiana",4,1,0.2,5
"6850","Michigan","Iowa",2,2,0.5,4
"6851","Michigan","Iowa St",1,0,0,1
"6852","Michigan","IUPUI",0,1,1,1
"6853","Michigan","Kansas St",0,1,1,1
"6854","Michigan","Long Beach St",0,1,1,1
"6855","Michigan","Maryland",1,0,0,1
"6856","Michigan","Michigan St",4,3,0.428571428571429,7
"6857","Michigan","Minnesota",0,4,1,4
"6858","Michigan","NC State",0,1,1,1
"6859","Michigan","Nebraska",0,4,1,4
"6860","Michigan","Nicholls St",0,1,1,1
"6861","Michigan","NJIT",1,0,0,1
"6862","Michigan","Northwestern",1,4,0.8,5
"6863","Michigan","Ohio St",2,4,0.666666666666667,6
"6864","Michigan","Oregon",0,1,1,1
"6865","Michigan","Penn St",1,3,0.75,4
"6866","Michigan","Pittsburgh",0,1,1,1
"6867","Michigan","Purdue",1,4,0.8,5
"6868","Michigan","Rutgers",0,2,1,2
"6869","Michigan","S Carolina St",0,1,1,1
"6870","Michigan","SMU",1,0,0,1
"6871","Michigan","Stanford",0,1,1,1
"6872","Michigan","Syracuse",0,1,1,1
"6873","Michigan","Villanova",1,0,0,1
"6874","Michigan","West Virginia",0,1,1,1
"6875","Michigan","Wisconsin",4,1,0.2,5
"6876","Michigan","W Michigan",0,1,1,1
"6877","Michigan","Hillsdale",0,1,1,1
"6878","Michigan","MA Lowell",0,1,1,1
"6879","Michigan St","Ark Pine Bluff",0,2,1,2
"6880","Michigan St","Boise St",0,1,1,1
"6881","Michigan St","Bowling Green",0,1,1,1
"6882","Michigan St","Citadel",0,1,1,1
"6883","Michigan St","Columbia",0,1,1,1
"6884","Michigan St","Connecticut",1,0,0,1
"6885","Michigan St","Duke",1,0,0,1
"6886","Michigan St","E Michigan",0,1,1,1
"6887","Michigan St","Georgetown",1,0,0,1
"6888","Michigan St","Illinois",2,3,0.6,5
"6889","Michigan St","Indiana",2,4,0.666666666666667,6
"6890","Michigan St","Iowa",0,4,1,4
"6891","Michigan St","Kansas",1,1,0.5,2
"6892","Michigan St","Kentucky",0,1,1,1
"6893","Michigan St","Loyola-Chicago",0,2,1,2
"6894","Michigan St","Marquette",0,1,1,1
"6895","Michigan St","Maryland",2,1,0.333333333333333,3
"6896","Michigan St","McNeese St",0,1,1,1
"6897","Michigan St","Miami FL",1,0,0,1
"6898","Michigan St","Michigan",3,4,0.571428571428571,7
"6899","Michigan St","Minnesota",2,2,0.5,4
"6900","Michigan St","Mt St Mary's",0,1,1,1
"6901","Michigan St","Navy",0,1,1,1
"6902","Michigan St","Nebraska",2,2,0.5,4
"6903","Michigan St","New Orleans",0,1,1,1
"6904","Michigan St","Nicholls St",0,1,1,1
"6905","Michigan St","North Carolina",1,0,0,1
"6906","Michigan St","North Florida",0,1,1,1
"6907","Michigan St","Northwestern",0,6,1,6
"6908","Michigan St","Notre Dame",1,0,0,1
"6909","Michigan St","Oakland",0,3,1,3
"6910","Michigan St","Ohio St",2,4,0.666666666666667,6
"6911","Michigan St","Oklahoma",0,1,1,1
"6912","Michigan St","Penn St",0,4,1,4
"6913","Michigan St","Portland",0,1,1,1
"6914","Michigan St","Purdue",0,4,1,4
"6915","Michigan St","Rider",0,1,1,1
"6916","Michigan St","Rutgers",0,1,1,1
"6917","Michigan St","Santa Clara",0,1,1,1
"6918","Michigan St","Texas",0,2,1,2
"6919","Michigan St","TX Southern",1,1,0.5,2
"6920","Michigan St","ULL",0,1,1,1
"6921","Michigan St","Virginia Tech",0,1,1,1
"6922","Michigan St","Wisconsin",3,3,0.5,6
"6923","Middle Tenn St","Akron",1,1,0.5,2
"6924","Middle Tenn St","Alabama St",0,1,1,1
"6925","Middle Tenn St","Arkansas St",1,1,0.5,2
"6926","Middle Tenn St","Ark Little Rock",0,3,1,3
"6927","Middle Tenn St","Belmont",2,0,0,2
"6928","Middle Tenn St","Charlotte",0,1,1,1
"6929","Middle Tenn St","Cincinnati",1,0,0,1
"6930","Middle Tenn St","East Carolina",0,1,1,1
"6931","Middle Tenn St","FL Atlantic",0,3,1,3
"6932","Middle Tenn St","Florida",2,0,0,2
"6933","Middle Tenn St","Florida Intl",0,3,1,3
"6934","Middle Tenn St","Louisiana Tech",1,0,0,1
"6935","Middle Tenn St","Maine",1,0,0,1
"6936","Middle Tenn St","Marshall",0,1,1,1
"6937","Middle Tenn St","Mississippi",1,1,0.5,2
"6938","Middle Tenn St","Murray St",0,1,1,1
"6939","Middle Tenn St","North Florida",0,1,1,1
"6940","Middle Tenn St","North Texas",0,3,1,3
"6941","Middle Tenn St","Old Dominion",0,2,1,2
"6942","Middle Tenn St","Rice",0,1,1,1
"6943","Middle Tenn St","Savannah St",0,1,1,1
"6944","Middle Tenn St","South Alabama",0,3,1,3
"6945","Middle Tenn St","Southern Miss",0,1,1,1
"6946","Middle Tenn St","Southern Univ",0,1,1,1
"6947","Middle Tenn St","Tennessee St",0,2,1,2
"6948","Middle Tenn St","Troy",0,2,1,2
"6949","Middle Tenn St","Tulane",0,1,1,1
"6950","Middle Tenn St","Tulsa",2,0,0,2
"6951","Middle Tenn St","TX Southern",0,1,1,1
"6952","Middle Tenn St","UAB",0,3,1,3
"6953","Middle Tenn St","UCF",0,1,1,1
"6954","Middle Tenn St","ULL",0,2,1,2
"6955","Middle Tenn St","ULM",0,2,1,2
"6956","Middle Tenn St","UTEP",1,0,0,1
"6957","Middle Tenn St","UT San Antonio",0,1,1,1
"6958","Middle Tenn St","Vanderbilt",0,1,1,1
"6959","Middle Tenn St","W Kentucky",0,2,1,2
"6960","Middle Tenn St","Fisk",0,1,1,1
"6961","Middle Tenn St","Grand Canyon",0,1,1,1
"6962","Middle Tenn St","TN Temple",0,1,1,1
"6963","Minnesota","American Univ",0,1,1,1
"6964","Minnesota","Arkansas",1,0,0,1
"6965","Minnesota","Coastal Car",0,1,1,1
"6966","Minnesota","Duke",1,0,0,1
"6967","Minnesota","Florida St",0,2,1,2
"6968","Minnesota","Furman",0,1,1,1
"6969","Minnesota","Georgia",0,1,1,1
"6970","Minnesota","Illinois",2,2,0.5,4
"6971","Minnesota","Indiana",2,2,0.5,4
"6972","Minnesota","Iowa",3,3,0.5,6
"6973","Minnesota","Lafayette",0,1,1,1
"6974","Minnesota","Lehigh",0,1,1,1
"6975","Minnesota","Louisville",1,0,0,1
"6976","Minnesota","Maryland",1,0,0,1
"6977","Minnesota","Memphis",0,1,1,1
"6978","Minnesota","Michigan",4,0,0,4
"6979","Minnesota","Michigan St",2,2,0.5,4
"6980","Minnesota","Montana",0,1,1,1
"6981","Minnesota","N Dakota St",0,1,1,1
"6982","Minnesota","Nebraska",3,2,0.4,5
"6983","Minnesota","NE Omaha",0,1,1,1
"6984","Minnesota","New Orleans",0,1,1,1
"6985","Minnesota","North Dakota",0,1,1,1
"6986","Minnesota","North Florida",0,1,1,1
"6987","Minnesota","Northwestern",3,2,0.4,5
"6988","Minnesota","Ohio St",4,1,0.2,5
"6989","Minnesota","Penn St",2,4,0.666666666666667,6
"6990","Minnesota","Purdue",3,2,0.4,5
"6991","Minnesota","Richmond",0,2,1,2
"6992","Minnesota","Rutgers",0,2,1,2
"6993","Minnesota","S Dakota St",0,2,1,2
"6994","Minnesota","Seattle",0,1,1,1
"6995","Minnesota","Southern Univ",0,1,1,1
"6996","Minnesota","Stanford",0,1,1,1
"6997","Minnesota","St John's",1,0,0,1
"6998","Minnesota","Syracuse",1,0,0,1
"6999","Minnesota","TAM C. Christi",0,1,1,1
"7000","Minnesota","Tennessee St",0,1,1,1
"7001","Minnesota","Toledo",0,1,1,1
"7002","Minnesota","UNC Wilmington",0,1,1,1
"7003","Minnesota","USC",0,1,1,1
"7004","Minnesota","Wake Forest",0,1,1,1
"7005","Minnesota","W Carolina",0,1,1,1
"7006","Minnesota","Wisconsin",5,2,0.285714285714286,7
"7007","Minnesota","W Kentucky",0,1,1,1
"7008","Minnesota","Wofford",0,1,1,1
"7009","Minnesota","Chaminade",0,1,1,1
"7010","Minnesota","UMBC",0,1,1,1
"7011","Minnesota","Franklin Pierce",0,1,1,1
"7012","Mississippi","Alabama",1,3,0.75,4
"7013","Mississippi","Arkansas",2,2,0.5,4
"7014","Mississippi","Ark Little Rock",0,1,1,1
"7015","Mississippi","Auburn",0,4,1,4
"7016","Mississippi","Austin Peay",0,1,1,1
"7017","Mississippi","Charleston So",1,0,0,1
"7018","Mississippi","Cincinnati",0,1,1,1
"7019","Mississippi","Coastal Car",0,3,1,3
"7020","Mississippi","Creighton",0,1,1,1
"7021","Mississippi","Dayton",2,0,0,2
"7022","Mississippi","ETSU",0,1,1,1
"7023","Mississippi","Florida",2,2,0.5,4
"7024","Mississippi","Fordham",0,1,1,1
"7025","Mississippi","Georgia",4,1,0.2,5
"7026","Mississippi","Georgia Tech",0,1,1,1
"7027","Mississippi","Hawaii",0,1,1,1
"7028","Mississippi","Indiana St",1,0,0,1
"7029","Mississippi","Kansas St",1,0,0,1
"7030","Mississippi","Kentucky",4,0,0,4
"7031","Mississippi","Lipscomb",0,1,1,1
"7032","Mississippi","Loy Marymount",0,1,1,1
"7033","Mississippi","LSU",2,2,0.5,4
"7034","Mississippi","McNeese St",0,1,1,1
"7035","Mississippi","Mercer",1,0,0,1
"7036","Mississippi","Middle Tenn St",1,1,0.5,2
"7037","Mississippi","Mississippi St",2,5,0.714285714285714,7
"7038","Mississippi","Missouri",1,3,0.75,4
"7039","Mississippi","MS Valley St",0,2,1,2
"7040","Mississippi","NC A&T",0,1,1,1
"7041","Mississippi","Northern Arizona",0,1,1,1
"7042","Mississippi","Oregon",1,1,0.5,2
"7043","Mississippi","Penn St",0,1,1,1
"7044","Mississippi","Rutgers",0,1,1,1
"7045","Mississippi","San Francisco",0,1,1,1
"7046","Mississippi","SE Missouri St",0,1,1,1
"7047","Mississippi","South Carolina",2,3,0.6,5
"7048","Mississippi","Southern Univ",0,1,1,1
"7049","Mississippi","TCU",1,0,0,1
"7050","Mississippi","Tennessee",1,3,0.75,4
"7051","Mississippi","Texas A&M",2,2,0.5,4
"7052","Mississippi","Troy",0,2,1,2
"7053","Mississippi","ULM",0,1,1,1
"7054","Mississippi","Vanderbilt",1,3,0.75,4
"7055","Mississippi","W Kentucky",1,1,0.5,2
"7056","Mississippi St","Alabama",4,0,0,4
"7057","Mississippi St","Alabama A&M",1,0,0,1
"7058","Mississippi St","Alcorn St",0,1,1,1
"7059","Mississippi St","Arkansas",4,0,0,4
"7060","Mississippi St","Arkansas St",1,0,0,1
"7061","Mississippi St","Auburn",2,3,0.6,5
"7062","Mississippi St","Cent Arkansas",0,1,1,1
"7063","Mississippi St","FL Atlantic",0,1,1,1
"7064","Mississippi St","FL Gulf Coast",0,1,1,1
"7065","Mississippi St","Florida",4,0,0,4
"7066","Mississippi St","Florida A&M",0,1,1,1
"7067","Mississippi St","Florida St",0,1,1,1
"7068","Mississippi St","Georgia",3,1,0.25,4
"7069","Mississippi St","Jackson St",0,1,1,1
"7070","Mississippi St","Jacksonville",0,1,1,1
"7071","Mississippi St","Kennesaw",0,1,1,1
"7072","Mississippi St","Kentucky",4,0,0,4
"7073","Mississippi St","Loyola-Chicago",1,1,0.5,2
"7074","Mississippi St","LSU",3,1,0.25,4
"7075","Mississippi St","Marquette",1,0,0,1
"7076","Mississippi St","McNeese St",1,0,0,1
"7077","Mississippi St","MD E Shore",0,1,1,1
"7078","Mississippi St","Mississippi",5,2,0.285714285714286,7
"7079","Mississippi St","Missouri",2,2,0.5,4
"7080","Mississippi St","MS Valley St",0,2,1,2
"7081","Mississippi St","New Orleans",0,1,1,1
"7082","Mississippi St","North Carolina",1,0,0,1
"7083","Mississippi St","Oregon St",1,0,0,1
"7084","Mississippi St","Prairie View",0,1,1,1
"7085","Mississippi St","Providence",1,0,0,1
"7086","Mississippi St","SC Upstate",1,0,0,1
"7087","Mississippi St","SE Louisiana",0,1,1,1
"7088","Mississippi St","South Carolina",3,1,0.25,4
"7089","Mississippi St","South Florida",0,1,1,1
"7090","Mississippi St","St Louis",0,1,1,1
"7091","Mississippi St","TCU",2,0,0,2
"7092","Mississippi St","Tennessee",3,1,0.25,4
"7093","Mississippi St","Texas",1,0,0,1
"7094","Mississippi St","Texas A&M",3,1,0.25,4
"7095","Mississippi St","Troy",1,0,0,1
"7096","Mississippi St","Tulane",1,0,0,1
"7097","Mississippi St","UNLV",1,0,0,1
"7098","Mississippi St","Utah St",1,1,0.5,2
"7099","Mississippi St","UT San Antonio",0,1,1,1
"7100","Mississippi St","Vanderbilt",3,2,0.4,5
"7101","Mississippi St","W Carolina",0,1,1,1
"7102","Mississippi St","Clayton St",0,1,1,1
"7103","Missouri","Alabama",2,2,0.5,4
"7104","Missouri","Alcorn St",0,1,1,1
"7105","Missouri","Appalachian St",0,1,1,1
"7106","Missouri","Arizona",1,0,0,1
"7107","Missouri","Arkansas",3,3,0.5,6
"7108","Missouri","Auburn",1,3,0.75,4
"7109","Missouri","Bucknell",0,1,1,1
"7110","Missouri","Edwardsville",0,1,1,1
"7111","Missouri","Elon",0,1,1,1
"7112","Missouri","Florida",3,2,0.4,5
"7113","Missouri","Gardner Webb",0,1,1,1
"7114","Missouri","Georgia",3,1,0.25,4
"7115","Missouri","Hawaii",0,1,1,1
"7116","Missouri","Illinois",2,1,0.333333333333333,3
"7117","Missouri","IUPUI",0,1,1,1
"7118","Missouri","Kentucky",4,0,0,4
"7119","Missouri","Lipscomb",0,1,1,1
"7120","Missouri","Long Beach St",0,1,1,1
"7121","Missouri","Louisville",1,0,0,1
"7122","Missouri","LSU",2,2,0.5,4
"7123","Missouri","Mississippi",3,1,0.25,4
"7124","Missouri","Mississippi St",2,2,0.5,4
"7125","Missouri","Missouri KC",1,0,0,1
"7126","Missouri","NC State",0,1,1,1
"7127","Missouri","Nevada",0,1,1,1
"7128","Missouri","Nicholls St",0,1,1,1
"7129","Missouri","Northwestern",0,1,1,1
"7130","Missouri","Oklahoma",1,0,0,1
"7131","Missouri","Oklahoma St",1,0,0,1
"7132","Missouri","Oral Roberts",0,1,1,1
"7133","Missouri","Purdue",1,0,0,1
"7134","Missouri","S Carolina St",0,1,1,1
"7135","Missouri","SE Louisiana",0,1,1,1
"7136","Missouri","SE Missouri St",0,2,1,2
"7137","Missouri","S Illinois",0,1,1,1
"7138","Missouri","South Carolina",2,3,0.6,5
"7139","Missouri","Stanford",0,1,1,1
"7140","Missouri","Tennessee",3,1,0.25,4
"7141","Missouri","Tennessee St",0,1,1,1
"7142","Missouri","Texas A&M",3,2,0.4,5
"7143","Missouri","UCLA",1,1,0.5,2
"7144","Missouri","VA Commonwealth",0,1,1,1
"7145","Missouri","Valparaiso",0,1,1,1
"7146","Missouri","Vanderbilt",2,2,0.5,4
"7147","Missouri","West Virginia",0,1,1,1
"7148","Missouri","W Michigan",0,1,1,1
"7149","Missouri","Xavier",1,0,0,1
"7150","Missouri","Chaminade",0,1,1,1
"7151","Missouri KC","Albany NY",1,0,0,1
"7152","Missouri KC","Appalachian St",1,0,0,1
"7153","Missouri KC","Ark Little Rock",1,0,0,1
"7154","Missouri KC","Canisius",1,0,0,1
"7155","Missouri KC","Chicago St",2,2,0.5,4
"7156","Missouri KC","Creighton",1,0,0,1
"7157","Missouri KC","CS Bakersfield",2,2,0.5,4
"7158","Missouri KC","Houston Bap",2,0,0,2
"7159","Missouri KC","Idaho",2,1,0.333333333333333,3
"7160","Missouri KC","Indiana St",1,1,0.5,2
"7161","Missouri KC","Iowa St",3,0,0,3
"7162","Missouri KC","IPFW",1,1,0.5,2
"7163","Missouri KC","IUPUI",0,2,1,2
"7164","Missouri KC","Kansas St",2,0,0,2
"7165","Missouri KC","Louisville",2,0,0,2
"7166","Missouri KC","Miami OH",1,1,0.5,2
"7167","Missouri KC","Missouri",0,1,1,1
"7168","Missouri KC","N Dakota St",2,0,0,2
"7169","Missouri KC","NE Omaha",3,1,0.25,4
"7170","Missouri KC","New Mexico St",3,1,0.25,4
"7171","Missouri KC","Norfolk St",0,1,1,1
"7172","Missouri KC","North Dakota",0,1,1,1
"7173","Missouri KC","Oakland",2,0,0,2
"7174","Missouri KC","Ohio St",1,0,0,1
"7175","Missouri KC","Samford",1,0,0,1
"7176","Missouri KC","SC Upstate",1,0,0,1
"7177","Missouri KC","S Dakota St",4,0,0,4
"7178","Missouri KC","Seattle",2,3,0.6,5
"7179","Missouri KC","SE Missouri St",2,0,0,2
"7180","Missouri KC","Seton Hall",1,0,0,1
"7181","Missouri KC","South Dakota",0,2,1,2
"7182","Missouri KC","Tennessee Tech",2,0,0,2
"7183","Missouri KC","TN Martin",0,1,1,1
"7184","Missouri KC","TX Pan American",3,2,0.4,5
"7185","Missouri KC","Utah Valley",2,3,0.6,5
"7186","Missouri KC","W Illinois",2,0,0,2
"7187","Missouri KC","WI Milwaukee",2,0,0,2
"7188","Missouri KC","Wright St",1,0,0,1
"7189","Missouri KC","Youngstown St",1,1,0.5,2
"7190","Missouri KC","Emporia St",1,0,0,1
"7191","Missouri KC","Grand Canyon",2,2,0.5,4
"7192","Missouri KC","Incarnate Word",1,0,0,1
"7193","Missouri KC","Missouri S&T",0,1,1,1
"7194","Missouri KC","Wm Jewell",0,1,1,1
"7195","Missouri St","Alabama A&M",1,1,0.5,2
"7196","Missouri St","Ark Little Rock",0,1,1,1
"7197","Missouri St","Bradley",2,4,0.666666666666667,6
"7198","Missouri St","Colorado St",1,0,0,1
"7199","Missouri St","Creighton",2,0,0,2
"7200","Missouri St","Drake",2,4,0.666666666666667,6
"7201","Missouri St","E Illinois",0,1,1,1
"7202","Missouri St","E Michigan",1,1,0.5,2
"7203","Missouri St","Evansville",3,3,0.5,6
"7204","Missouri St","Grambling",0,1,1,1
"7205","Missouri St","Hampton",0,1,1,1
"7206","Missouri St","Illinois St",4,3,0.428571428571429,7
"7207","Missouri St","Indiana St",3,3,0.5,6
"7208","Missouri St","Jacksonville",1,0,0,1
"7209","Missouri St","Liberty",0,1,1,1
"7210","Missouri St","Louisville",1,0,0,1
"7211","Missouri St","Loyola-Chicago",3,1,0.25,4
"7212","Missouri St","New Mexico St",1,0,0,1
"7213","Missouri St","Northern Iowa",6,0,0,6
"7214","Missouri St","Oklahoma St",1,0,0,1
"7215","Missouri St","Old Dominion",0,1,1,1
"7216","Missouri St","Oral Roberts",2,2,0.5,4
"7217","Missouri St","San Diego St",1,0,0,1
"7218","Missouri St","SE Missouri St",0,2,1,2
"7219","Missouri St","S Illinois",3,4,0.571428571428571,7
"7220","Missouri St","SMU",1,0,0,1
"7221","Missouri St","South Carolina",1,0,0,1
"7222","Missouri St","Texas A&M",0,1,1,1
"7223","Missouri St","Texas Tech",1,0,0,1
"7224","Missouri St","Tulsa",2,1,0.333333333333333,3
"7225","Missouri St","Valparaiso",1,0,0,1
"7226","Missouri St","Virginia",1,0,0,1
"7227","Missouri St","Washington St",1,0,0,1
"7228","Missouri St","Wichita St",7,0,0,7
"7229","Missouri St","AK Anchorage",0,1,1,1
"7230","Missouri St","Cameron",0,1,1,1
"7231","Missouri St","Avila",0,1,1,1
"7232","Monmouth NJ","Bethune-Cookman",0,1,1,1
"7233","Monmouth NJ","Binghamton",0,2,1,2
"7234","Monmouth NJ","Bryant",1,0,0,1
"7235","Monmouth NJ","Canisius",1,4,0.8,5
"7236","Monmouth NJ","Central Conn",1,1,0.5,2
"7237","Monmouth NJ","Fairfield",1,3,0.75,4
"7238","Monmouth NJ","F Dickinson",0,2,1,2
"7239","Monmouth NJ","Fordham",2,1,0.333333333333333,3
"7240","Monmouth NJ","Georgia St",1,0,0,1
"7241","Monmouth NJ","Hofstra",0,2,1,2
"7242","Monmouth NJ","Iona",4,1,0.2,5
"7243","Monmouth NJ","Lafayette",0,1,1,1
"7244","Monmouth NJ","Long Island",2,0,0,2
"7245","Monmouth NJ","Manhattan",4,0,0,4
"7246","Monmouth NJ","Marist",2,2,0.5,4
"7247","Monmouth NJ","Maryland",2,0,0,2
"7248","Monmouth NJ","MS Valley St",0,1,1,1
"7249","Monmouth NJ","Mt St Mary's",2,0,0,2
"7250","Monmouth NJ","Navy",1,0,0,1
"7251","Monmouth NJ","NC A&T",0,1,1,1
"7252","Monmouth NJ","Niagara",0,4,1,4
"7253","Monmouth NJ","Notre Dame",1,0,0,1
"7254","Monmouth NJ","Penn",1,1,0.5,2
"7255","Monmouth NJ","Penn St",1,0,0,1
"7256","Monmouth NJ","Quinnipiac",5,0,0,5
"7257","Monmouth NJ","Rider",5,1,0.166666666666667,6
"7258","Monmouth NJ","Robert Morris",2,0,0,2
"7259","Monmouth NJ","Rutgers",1,0,0,1
"7260","Monmouth NJ","Sacred Heart",1,0,0,1
"7261","Monmouth NJ","Seton Hall",1,0,0,1
"7262","Monmouth NJ","Siena",1,3,0.75,4
"7263","Monmouth NJ","SMU",1,0,0,1
"7264","Monmouth NJ","South Alabama",0,1,1,1
"7265","Monmouth NJ","St Francis NY",1,3,0.75,4
"7266","Monmouth NJ","St Francis PA",1,1,0.5,2
"7267","Monmouth NJ","St John's",1,0,0,1
"7268","Monmouth NJ","St Peter's",3,1,0.25,4
"7269","Monmouth NJ","Syracuse",1,0,0,1
"7270","Monmouth NJ","Tennessee St",0,1,1,1
"7271","Monmouth NJ","Towson",1,0,0,1
"7272","Monmouth NJ","Villanova",1,0,0,1
"7273","Monmouth NJ","Wagner",3,1,0.25,4
"7274","Monmouth NJ","West Virginia",1,0,0,1
"7275","Montana","Boise St",1,0,0,1
"7276","Montana","BYU",1,0,0,1
"7277","Montana","California",1,0,0,1
"7278","Montana","Colorado St",2,0,0,2
"7279","Montana","CS Sacramento",1,4,0.8,5
"7280","Montana","Davidson",2,0,0,2
"7281","Montana","E Washington",3,4,0.571428571428571,7
"7282","Montana","Hawaii",1,0,0,1
"7283","Montana","Idaho",1,4,0.8,5
"7284","Montana","Idaho St",0,6,1,6
"7285","Montana","Minnesota",1,0,0,1
"7286","Montana","Montana St",0,6,1,6
"7287","Montana","N Colorado",2,4,0.666666666666667,6
"7288","Montana","N Dakota St",0,1,1,1
"7289","Montana","North Dakota",1,5,0.833333333333333,6
"7290","Montana","Northern Arizona",2,4,0.666666666666667,6
"7291","Montana","Portland St",2,4,0.666666666666667,6
"7292","Montana","San Diego",0,1,1,1
"7293","Montana","San Francisco",3,0,0,3
"7294","Montana","S Dakota St",1,1,0.5,2
"7295","Montana","Seattle",0,1,1,1
"7296","Montana","South Dakota",1,0,0,1
"7297","Montana","Southern Utah",0,5,1,5
"7298","Montana","Washington",1,0,0,1
"7299","Montana","Weber St",3,4,0.571428571428571,7
"7300","Montana","WI Milwaukee",1,0,0,1
"7301","Montana","Carroll MT",0,1,1,1
"7302","Montana","MT Western",0,1,1,1
"7303","Montana","St Martin's",0,1,1,1
"7304","Montana","MT Tech",0,1,1,1
"7305","Montana St","Air Force",1,0,0,1
"7306","Montana St","Austin Peay",1,0,0,1
"7307","Montana St","C Michigan",0,1,1,1
"7308","Montana St","CS Fullerton",1,0,0,1
"7309","Montana St","CS Northridge",2,1,0.333333333333333,3
"7310","Montana St","CS Sacramento",3,2,0.4,5
"7311","Montana St","E Washington",5,1,0.166666666666667,6
"7312","Montana St","Idaho",2,0,0,2
"7313","Montana St","Idaho St",3,3,0.5,6
"7314","Montana St","Kentucky",1,0,0,1
"7315","Montana St","Montana",6,0,0,6
"7316","Montana St","N Colorado",3,3,0.5,6
"7317","Montana St","N Dakota St",1,0,0,1
"7318","Montana St","North Dakota",4,2,0.333333333333333,6
"7319","Montana St","Northern Arizona",3,2,0.4,5
"7320","Montana St","Oregon St",1,0,0,1
"7321","Montana St","Pepperdine",1,0,0,1
"7322","Montana St","Portland",1,2,0.666666666666667,3
"7323","Montana St","Portland St",1,4,0.8,5
"7324","Montana St","San Jose St",1,0,0,1
"7325","Montana St","Seattle",1,0,0,1
"7326","Montana St","South Dakota",2,0,0,2
"7327","Montana St","Southern Utah",0,5,1,5
"7328","Montana St","UCLA",1,0,0,1
"7329","Montana St","UC Riverside",1,0,0,1
"7330","Montana St","Utah Valley",0,1,1,1
"7331","Montana St","UT Arlington",0,1,1,1
"7332","Montana St","UTEP",1,0,0,1
"7333","Montana St","Weber St",5,1,0.166666666666667,6
"7334","Montana St","Wyoming",3,0,0,3
"7335","Montana St","Grand Canyon",1,0,0,1
"7336","Montana St","SW Christian",0,1,1,1
"7337","Montana St","Walla Walla",0,1,1,1
"7338","Montana St","S Dakota Tech",0,1,1,1
"7339","Morehead St","American Univ",1,0,0,1
"7340","Morehead St","Austin Peay",1,2,0.666666666666667,3
"7341","Morehead St","Belmont",6,1,0.142857142857143,7
"7342","Morehead St","Bowling Green",1,0,0,1
"7343","Morehead St","Cent Arkansas",0,1,1,1
"7344","Morehead St","Chattanooga",0,1,1,1
"7345","Morehead St","Cincinnati",1,0,0,1
"7346","Morehead St","Edwardsville",0,3,1,3
"7347","Morehead St","E Illinois",1,2,0.666666666666667,3
"7348","Morehead St","E Kentucky",5,1,0.166666666666667,6
"7349","Morehead St","ETSU",1,1,0.5,2
"7350","Morehead St","Gardner Webb",1,0,0,1
"7351","Morehead St","Indiana St",0,1,1,1
"7352","Morehead St","Jacksonville St",1,5,0.833333333333333,6
"7353","Morehead St","Kentucky",1,0,0,1
"7354","Morehead St","Lafayette",0,1,1,1
"7355","Morehead St","Long Island",0,1,1,1
"7356","Morehead St","Louisiana Tech",1,0,0,1
"7357","Morehead St","Marshall",1,2,0.666666666666667,3
"7358","Morehead St","Maryland",1,0,0,1
"7359","Morehead St","Murray St",4,0,0,4
"7360","Morehead St","N Dakota St",2,0,0,2
"7361","Morehead St","Nevada",0,1,1,1
"7362","Morehead St","N Kentucky",1,1,0.5,2
"7363","Morehead St","Norfolk St",0,1,1,1
"7364","Morehead St","Oakland",2,0,0,2
"7365","Morehead St","Ohio St",1,0,0,1
"7366","Morehead St","Presbyterian",0,1,1,1
"7367","Morehead St","SE Missouri St",0,4,1,4
"7368","Morehead St","South Dakota",1,1,0.5,2
"7369","Morehead St","Southern Miss",2,0,0,2
"7370","Morehead St","Tennessee",1,0,0,1
"7371","Morehead St","Tennessee St",1,5,0.833333333333333,6
"7372","Morehead St","Tennessee Tech",2,5,0.714285714285714,7
"7373","Morehead St","TN Martin",1,3,0.75,4
"7374","Morehead St","UAB",1,0,0,1
"7375","Morehead St","UCLA",1,0,0,1
"7376","Morehead St","UNLV",1,0,0,1
"7377","Morehead St","WI Green Bay",1,0,0,1
"7378","Morehead St","Wright St",1,1,0.5,2
"7379","Morehead St","Xavier",1,0,0,1
"7380","Morehead St","Asbury",0,1,1,1
"7381","Morehead St","Cincinnati Chr",0,1,1,1
"7382","Morehead St","Mid-Continent",0,1,1,1
"7383","Morehead St","Kentucky Chr",0,1,1,1
"7384","Morgan St","Bethune-Cookman",1,1,0.5,2
"7385","Morgan St","Coppin St",2,5,0.714285714285714,7
"7386","Morgan St","CS Northridge",2,0,0,2
"7387","Morgan St","Delaware St",2,3,0.6,5
"7388","Morgan St","Elon",1,0,0,1
"7389","Morgan St","Florida A&M",1,3,0.75,4
"7390","Morgan St","Hampton",4,3,0.428571428571429,7
"7391","Morgan St","High Point",0,2,1,2
"7392","Morgan St","Holy Cross",1,0,0,1
"7393","Morgan St","Houston",1,0,0,1
"7394","Morgan St","Howard",1,3,0.75,4
"7395","Morgan St","Illinois St",1,0,0,1
"7396","Morgan St","La Salle",1,0,0,1
"7397","Morgan St","Liberty",0,2,1,2
"7398","Morgan St","Loy Marymount",1,0,0,1
"7399","Morgan St","Manhattan",1,0,0,1
"7400","Morgan St","Marist",0,1,1,1
"7401","Morgan St","Marquette",1,0,0,1
"7402","Morgan St","Maryland",1,0,0,1
"7403","Morgan St","MD E Shore",2,3,0.6,5
"7404","Morgan St","NC A&T",2,1,0.333333333333333,3
"7405","Morgan St","NC Central",4,0,0,4
"7406","Morgan St","Norfolk St",4,2,0.333333333333333,6
"7407","Morgan St","Northern Iowa",1,0,0,1
"7408","Morgan St","Ohio",1,0,0,1
"7409","Morgan St","Ohio St",1,0,0,1
"7410","Morgan St","Old Dominion",1,0,0,1
"7411","Morgan St","Oregon",1,0,0,1
"7412","Morgan St","Penn St",1,0,0,1
"7413","Morgan St","Rider",1,0,0,1
"7414","Morgan St","San Diego",2,0,0,2
"7415","Morgan St","Savannah St",1,1,0.5,2
"7416","Morgan St","S Carolina St",0,3,1,3
"7417","Morgan St","South Carolina",1,0,0,1
"7418","Morgan St","St Joseph's PA",1,0,0,1
"7419","Morgan St","St Mary's CA",1,0,0,1
"7420","Morgan St","Towson",2,0,0,2
"7421","Morgan St","UC Irvine",1,1,0.5,2
"7422","Morgan St","UC Riverside",1,0,0,1
"7423","Morgan St","UT San Antonio",0,1,1,1
"7424","Morgan St","Vanderbilt",1,0,0,1
"7425","Morgan St","Virginia",1,0,0,1
"7426","Morgan St","Virginia Tech",1,0,0,1
"7427","Morgan St","VMI",0,1,1,1
"7428","MS Valley St","Alabama A&M",5,1,0.166666666666667,6
"7429","MS Valley St","Alabama St",7,0,0,7
"7430","MS Valley St","Alcorn St",4,2,0.333333333333333,6
"7431","MS Valley St","Ark Pine Bluff",5,1,0.166666666666667,6
"7432","MS Valley St","Bradley",1,0,0,1
"7433","MS Valley St","Cincinnati",1,0,0,1
"7434","MS Valley St","CS Bakersfield",1,0,0,1
"7435","MS Valley St","Ga Southern",1,0,0,1
"7436","MS Valley St","Georgia Tech",1,0,0,1
"7437","MS Valley St","Grambling",1,5,0.833333333333333,6
"7438","MS Valley St","Houston",1,0,0,1
"7439","MS Valley St","Indiana",1,0,0,1
"7440","MS Valley St","Iowa St",1,0,0,1
"7441","MS Valley St","Jackson St",4,2,0.333333333333333,6
"7442","MS Valley St","Longwood",0,1,1,1
"7443","MS Valley St","LSU",1,0,0,1
"7444","MS Valley St","Mississippi",2,0,0,2
"7445","MS Valley St","Mississippi St",2,0,0,2
"7446","MS Valley St","Monmouth NJ",1,0,0,1
"7447","MS Valley St","NC A&T",0,1,1,1
"7448","MS Valley St","NC Central",1,0,0,1
"7449","MS Valley St","N Illinois",1,0,0,1
"7450","MS Valley St","North Texas",1,0,0,1
"7451","MS Valley St","Northwestern",3,0,0,3
"7452","MS Valley St","Oklahoma St",1,0,0,1
"7453","MS Valley St","Oregon St",1,0,0,1
"7454","MS Valley St","Prairie View",4,3,0.428571428571429,7
"7455","MS Valley St","Southern Univ",5,1,0.166666666666667,6
"7456","MS Valley St","TAM C. Christi",1,0,0,1
"7457","MS Valley St","TCU",2,0,0,2
"7458","MS Valley St","Texas A&M",1,0,0,1
"7459","MS Valley St","Tulane",1,0,0,1
"7460","MS Valley St","TX Southern",6,0,0,6
"7461","MS Valley St","Virginia",1,0,0,1
"7462","MS Valley St","Virginia Tech",1,0,0,1
"7463","MS Valley St","Washington",1,0,0,1
"7464","MS Valley St","Washington St",1,0,0,1
"7465","MS Valley St","Champion Bap",0,1,1,1
"7466","MS Valley St","Selma AL",0,1,1,1
"7467","MS Valley St","Tougaloo",0,1,1,1
"7468","Mt St Mary's","American Univ",2,1,0.333333333333333,3
"7469","Mt St Mary's","Arizona",1,0,0,1
"7470","Mt St Mary's","Binghamton",1,2,0.666666666666667,3
"7471","Mt St Mary's","Bryant",3,4,0.571428571428571,7
"7472","Mt St Mary's","Bucknell",0,2,1,2
"7473","Mt St Mary's","BYU",1,0,0,1
"7474","Mt St Mary's","Central Conn",0,5,1,5
"7475","Mt St Mary's","F Dickinson",2,4,0.666666666666667,6
"7476","Mt St Mary's","Georgetown",1,0,0,1
"7477","Mt St Mary's","G Washington",0,1,1,1
"7478","Mt St Mary's","Hartford",0,1,1,1
"7479","Mt St Mary's","Indiana",1,0,0,1
"7480","Mt St Mary's","Long Island",2,4,0.666666666666667,6
"7481","Mt St Mary's","Loyola MD",1,2,0.666666666666667,3
"7482","Mt St Mary's","MD Baltimore Co",0,1,1,1
"7483","Mt St Mary's","MD E Shore",2,0,0,2
"7484","Mt St Mary's","Michigan St",1,0,0,1
"7485","Mt St Mary's","Monmouth NJ",0,2,1,2
"7486","Mt St Mary's","Navy",0,1,1,1
"7487","Mt St Mary's","Norfolk St",0,2,1,2
"7488","Mt St Mary's","Notre Dame",1,0,0,1
"7489","Mt St Mary's","Old Dominion",1,0,0,1
"7490","Mt St Mary's","Penn St",1,0,0,1
"7491","Mt St Mary's","Pittsburgh",1,0,0,1
"7492","Mt St Mary's","Quinnipiac",0,1,1,1
"7493","Mt St Mary's","Robert Morris",5,2,0.285714285714286,7
"7494","Mt St Mary's","Sacred Heart",2,3,0.6,5
"7495","Mt St Mary's","Seton Hall",1,0,0,1
"7496","Mt St Mary's","St Francis NY",2,4,0.666666666666667,6
"7497","Mt St Mary's","St Francis PA",2,4,0.666666666666667,6
"7498","Mt St Mary's","Texas Tech",1,0,0,1
"7499","Mt St Mary's","Villanova",1,0,0,1
"7500","Mt St Mary's","Wagner",4,3,0.428571428571429,7
"7501","Mt St Mary's","Wake Forest",1,0,0,1
"7502","Mt St Mary's","West Virginia",1,0,0,1
"7503","Mt St Mary's","W Michigan",1,0,0,1
"7504","Mt St Mary's","UMBC",1,0,0,1
"7505","Murray St","Alabama A&M",0,1,1,1
"7506","Murray St","Alcorn St",0,1,1,1
"7507","Murray St","Arkansas St",0,1,1,1
"7508","Murray St","Auburn",1,1,0.5,2
"7509","Murray St","Austin Peay",0,6,1,6
"7510","Murray St","Belmont",2,2,0.5,4
"7511","Murray St","Colorado",1,0,0,1
"7512","Murray St","Dayton",2,0,0,2
"7513","Murray St","Drake",0,1,1,1
"7514","Murray St","Edwardsville",2,4,0.666666666666667,6
"7515","Murray St","E Illinois",1,5,0.833333333333333,6
"7516","Murray St","E Kentucky",2,2,0.5,4
"7517","Murray St","Evansville",0,3,1,3
"7518","Murray St","Houston",1,0,0,1
"7519","Murray St","Illinois St",0,1,1,1
"7520","Murray St","Jacksonville St",1,2,0.666666666666667,3
"7521","Murray St","Lipscomb",0,2,1,2
"7522","Murray St","Middle Tenn St",1,0,0,1
"7523","Murray St","Morehead St",0,4,1,4
"7524","Murray St","Old Dominion",1,1,0.5,2
"7525","Murray St","Portland",1,0,0,1
"7526","Murray St","S Dakota St",0,1,1,1
"7527","Murray St","SE Missouri St",2,4,0.666666666666667,6
"7528","Murray St","S Illinois",0,2,1,2
"7529","Murray St","St John's",0,1,1,1
"7530","Murray St","St Mary's CA",1,0,0,1
"7531","Murray St","Tennessee St",0,3,1,3
"7532","Murray St","Tennessee Tech",0,3,1,3
"7533","Murray St","TN Martin",1,5,0.833333333333333,6
"7534","Murray St","Valparaiso",3,0,0,3
"7535","Murray St","W Kentucky",1,2,0.666666666666667,3
"7536","Murray St","Xavier",1,0,0,1
"7537","Murray St","Bethel TN",0,2,1,2
"7538","Murray St","Brescia",0,2,1,2
"7539","Murray St","MTSU",0,1,1,1
"7540","Navy","Albany NY",1,0,0,1
"7541","Navy","American Univ",4,2,0.333333333333333,6
"7542","Navy","Army",2,5,0.714285714285714,7
"7543","Navy","Binghamton",0,3,1,3
"7544","Navy","Boston Univ",4,0,0,4
"7545","Navy","Bryant",1,1,0.5,2
"7546","Navy","Bucknell",6,1,0.142857142857143,7
"7547","Navy","Citadel",1,1,0.5,2
"7548","Navy","Colgate",6,2,0.25,8
"7549","Navy","Delaware St",0,1,1,1
"7550","Navy","Holy Cross",5,1,0.166666666666667,6
"7551","Navy","IPFW",1,1,0.5,2
"7552","Navy","Lafayette",4,2,0.333333333333333,6
"7553","Navy","Lehigh",6,0,0,6
"7554","Navy","Loyola MD",2,2,0.5,4
"7555","Navy","MD E Shore",1,1,0.5,2
"7556","Navy","Michigan St",1,0,0,1
"7557","Navy","Monmouth NJ",0,1,1,1
"7558","Navy","Mt St Mary's",1,0,0,1
"7559","Navy","N Kentucky",2,0,0,2
"7560","Navy","Norfolk St",1,0,0,1
"7561","Navy","Northeastern",1,0,0,1
"7562","Navy","Notre Dame",1,0,0,1
"7563","Navy","Penn",1,0,0,1
"7564","Navy","Prairie View",1,0,0,1
"7565","Navy","Providence",1,0,0,1
"7566","Navy","Siena",1,0,0,1
"7567","Navy","St Francis PA",2,0,0,2
"7568","Navy","TCU",1,0,0,1
"7569","Navy","Towson",1,1,0.5,2
"7570","Navy","Tulane",1,0,0,1
"7571","Navy","UAB",1,0,0,1
"7572","Navy","Virginia",1,0,0,1
"7573","Navy","VMI",0,1,1,1
"7574","Navy","Goucher",0,1,1,1
"7575","Navy","UMBC",1,1,0.5,2
"7576","Navy","PSU-Harrisburg",0,1,1,1
"7577","NC A&T","Bethune-Cookman",3,3,0.5,6
"7578","NC A&T","Bradley",1,0,0,1
"7579","NC A&T","Campbell",0,1,1,1
"7580","NC A&T","Charlotte",2,0,0,2
"7581","NC A&T","Cincinnati",1,0,0,1
"7582","NC A&T","Coppin St",2,1,0.333333333333333,3
"7583","NC A&T","CS Bakersfield",1,1,0.5,2
"7584","NC A&T","Delaware St",2,1,0.333333333333333,3
"7585","NC A&T","East Carolina",1,0,0,1
"7586","NC A&T","E Kentucky",1,1,0.5,2
"7587","NC A&T","Florida A&M",2,4,0.666666666666667,6
"7588","NC A&T","Ga Southern",1,1,0.5,2
"7589","NC A&T","Georgia Tech",1,0,0,1
"7590","NC A&T","Hampton",1,1,0.5,2
"7591","NC A&T","Howard",3,1,0.25,4
"7592","NC A&T","Iowa St",1,0,0,1
"7593","NC A&T","Jacksonville St",1,0,0,1
"7594","NC A&T","Kent",1,0,0,1
"7595","NC A&T","Longwood",0,1,1,1
"7596","NC A&T","MD E Shore",2,1,0.333333333333333,3
"7597","NC A&T","Mississippi",1,0,0,1
"7598","NC A&T","Monmouth NJ",1,0,0,1
"7599","NC A&T","Morgan St",1,2,0.666666666666667,3
"7600","NC A&T","MS Valley St",1,0,0,1
"7601","NC A&T","NC Central",6,0,0,6
"7602","NC A&T","NJIT",0,2,1,2
"7603","NC A&T","N Kentucky",1,0,0,1
"7604","NC A&T","Norfolk St",2,0,0,2
"7605","NC A&T","Ohio St",1,0,0,1
"7606","NC A&T","Old Dominion",1,0,0,1
"7607","NC A&T","Radford",2,1,0.333333333333333,3
"7608","NC A&T","Rhode Island",1,0,0,1
"7609","NC A&T","Savannah St",3,3,0.5,6
"7610","NC A&T","S Carolina St",4,2,0.333333333333333,6
"7611","NC A&T","SC Upstate",2,0,0,2
"7612","NC A&T","Seton Hall",1,0,0,1
"7613","NC A&T","South Carolina",1,0,0,1
"7614","NC A&T","St Louis",2,0,0,2
"7615","NC A&T","Texas Tech",1,0,0,1
"7616","NC A&T","UNC Greensboro",0,1,1,1
"7617","NC A&T","Utah Valley",2,0,0,2
"7618","NC A&T","Wright St",1,1,0.5,2
"7619","NC A&T","Greensboro",0,2,1,2
"7620","NC A&T","NC Wesleyan",0,1,1,1
"7621","NC Central","Appalachian St",0,1,1,1
"7622","NC Central","Bethune-Cookman",0,6,1,6
"7623","NC Central","Campbell",0,1,1,1
"7624","NC Central","Cincinnati",2,0,0,2
"7625","NC Central","Coppin St",0,4,1,4
"7626","NC Central","Creighton",1,0,0,1
"7627","NC Central","Delaware St",1,3,0.75,4
"7628","NC Central","Drake",1,0,0,1
"7629","NC Central","E Illinois",0,1,1,1
"7630","NC Central","E Kentucky",1,0,0,1
"7631","NC Central","ETSU",1,0,0,1
"7632","NC Central","Florida A&M",1,5,0.833333333333333,6
"7633","NC Central","Hampton",0,3,1,3
"7634","NC Central","Howard",0,4,1,4
"7635","NC Central","IUPUI",1,1,0.5,2
"7636","NC Central","Jackson St",0,1,1,1
"7637","NC Central","Marquette",1,0,0,1
"7638","NC Central","Maryland",2,0,0,2
"7639","NC Central","MD E Shore",0,3,1,3
"7640","NC Central","Memphis",1,0,0,1
"7641","NC Central","Morgan St",0,4,1,4
"7642","NC Central","MS Valley St",0,1,1,1
"7643","NC Central","NC A&T",0,6,1,6
"7644","NC Central","NC State",0,1,1,1
"7645","NC Central","NJIT",0,2,1,2
"7646","NC Central","Norfolk St",0,3,1,3
"7647","NC Central","North Carolina",1,0,0,1
"7648","NC Central","Northern Arizona",0,1,1,1
"7649","NC Central","Old Dominion",0,1,1,1
"7650","NC Central","Savannah St",1,5,0.833333333333333,6
"7651","NC Central","S Carolina St",0,5,1,5
"7652","NC Central","South Dakota",1,0,0,1
"7653","NC Central","Southern Univ",0,1,1,1
"7654","NC Central","Utah Valley",0,2,1,2
"7655","NC Central","Wagner",1,0,0,1
"7656","NC Central","Wichita St",2,0,0,2
"7657","NC Central","Winthrop",0,2,1,2
"7658","NC Central","Wyoming",1,0,0,1
"7659","NC Central","Barber-Scotia",0,2,1,2
"7660","NC Central","J&W NC",0,2,1,2
"7661","NC Central","College of Faith",0,1,1,1
"7662","N Colorado","Bethune-Cookman",0,1,1,1
"7663","N Colorado","Cal Poly SLO",1,0,0,1
"7664","N Colorado","Colorado",1,0,0,1
"7665","N Colorado","Colorado St",3,0,0,3
"7666","N Colorado","CS Sacramento",3,3,0.5,6
"7667","N Colorado","E Washington",3,2,0.4,5
"7668","N Colorado","Florida A&M",0,1,1,1
"7669","N Colorado","Idaho",1,0,0,1
"7670","N Colorado","Idaho St",2,3,0.6,5
"7671","N Colorado","Jacksonville St",0,1,1,1
"7672","N Colorado","Kansas St",0,1,1,1
"7673","N Colorado","Montana",4,2,0.333333333333333,6
"7674","N Colorado","Montana St",3,3,0.5,6
"7675","N Colorado","NE Omaha",1,0,0,1
"7676","N Colorado","New Mexico St",2,0,0,2
"7677","N Colorado","North Dakota",2,4,0.666666666666667,6
"7678","N Colorado","Northern Arizona",3,5,0.625,8
"7679","N Colorado","Northern Iowa",1,0,0,1
"7680","N Colorado","Portland St",3,3,0.5,6
"7681","N Colorado","Prairie View",0,1,1,1
"7682","N Colorado","Southern Utah",1,5,0.833333333333333,6
"7683","N Colorado","Stetson",0,1,1,1
"7684","N Colorado","UC Davis",2,0,0,2
"7685","N Colorado","UC Riverside",1,1,0.5,2
"7686","N Colorado","Weber St",4,2,0.333333333333333,6
"7687","N Colorado","Wichita St",1,0,0,1
"7688","N Colorado","Wyoming",3,0,0,3
"7689","N Colorado","Black Hills St",0,1,1,1
"7690","N Colorado","Colorado Chr",0,2,1,2
"7691","N Colorado","Colorado Col",0,1,1,1
"7692","NC State","Appalachian St",0,1,1,1
"7693","NC State","Boise St",0,1,1,1
"7694","NC State","Boston College",1,3,0.75,4
"7695","NC State","Campbell",0,1,1,1
"7696","NC State","Charleston So",0,1,1,1
"7697","NC State","Cincinnati",2,0,0,2
"7698","NC State","Clemson",2,3,0.6,5
"7699","NC State","Cleveland St",0,1,1,1
"7700","NC State","Connecticut",0,1,1,1
"7701","NC State","Detroit",0,1,1,1
"7702","NC State","Duke",4,2,0.333333333333333,6
"7703","NC State","East Carolina",0,1,1,1
"7704","NC State","E Kentucky",0,1,1,1
"7705","NC State","FL Gulf Coast",0,1,1,1
"7706","NC State","Florida St",1,3,0.75,4
"7707","NC State","Georgia Tech",0,4,1,4
"7708","NC State","Hofstra",0,1,1,1
"7709","NC State","Jackson St",0,1,1,1
"7710","NC State","Jacksonville",0,1,1,1
"7711","NC State","Long Beach St",0,1,1,1
"7712","NC State","Louisiana Tech",0,1,1,1
"7713","NC State","Louisville",0,1,1,1
"7714","NC State","Maryland",1,1,0.5,2
"7715","NC State","Massachusetts",0,1,1,1
"7716","NC State","Miami FL",3,2,0.4,5
"7717","NC State","Miami OH",0,1,1,1
"7718","NC State","Michigan",1,0,0,1
"7719","NC State","Missouri",1,0,0,1
"7720","NC State","NC Central",1,0,0,1
"7721","NC State","Norfolk St",0,1,1,1
"7722","NC State","North Carolina",4,2,0.333333333333333,6
"7723","NC State","Northwestern",0,1,1,1
"7724","NC State","Notre Dame",1,1,0.5,2
"7725","NC State","Oklahoma St",1,0,0,1
"7726","NC State","Penn St",0,1,1,1
"7727","NC State","Pittsburgh",1,3,0.75,4
"7728","NC State","Purdue",1,0,0,1
"7729","NC State","Richmond",0,1,1,1
"7730","NC State","South Florida",0,1,1,1
"7731","NC State","Stanford",0,1,1,1
"7732","NC State","St Bonaventure",0,1,1,1
"7733","NC State","Syracuse",1,2,0.666666666666667,3
"7734","NC State","Tennessee",0,2,1,2
"7735","NC State","UNC Asheville",0,1,1,1
"7736","NC State","UNC Greensboro",0,2,1,2
"7737","NC State","Virginia",4,0,0,4
"7738","NC State","Virginia Tech",0,3,1,3
"7739","NC State","Wake Forest",3,3,0.5,6
"7740","NC State","West Virginia",1,0,0,1
"7741","NC State","W Michigan",0,1,1,1
"7742","NC State","Wofford",1,0,0,1
"7743","N Dakota St","Akron",1,1,0.5,2
"7744","N Dakota St","Alcorn St",0,1,1,1
"7745","N Dakota St","Bryant",0,1,1,1
"7746","N Dakota St","Delaware",0,1,1,1
"7747","N Dakota St","Denver",1,5,0.833333333333333,6
"7748","N Dakota St","Duquesne",0,1,1,1
"7749","N Dakota St","Hampton",0,1,1,1
"7750","N Dakota St","Indiana",1,0,0,1
"7751","N Dakota St","Iowa",1,0,0,1
"7752","N Dakota St","IPFW",2,5,0.714285714285714,7
"7753","N Dakota St","IUPUI",0,6,1,6
"7754","N Dakota St","James Madison",0,1,1,1
"7755","N Dakota St","Kennesaw",0,1,1,1
"7756","N Dakota St","Kent",1,0,0,1
"7757","N Dakota St","Minnesota",1,0,0,1
"7758","N Dakota St","Missouri KC",0,2,1,2
"7759","N Dakota St","Montana",1,0,0,1
"7760","N Dakota St","Montana St",0,1,1,1
"7761","N Dakota St","Morehead St",0,2,1,2
"7762","N Dakota St","NE Omaha",0,6,1,6
"7763","N Dakota St","North Dakota",1,2,0.666666666666667,3
"7764","N Dakota St","Notre Dame",0,1,1,1
"7765","N Dakota St","Oakland",1,1,0.5,2
"7766","N Dakota St","Ohio St",1,0,0,1
"7767","N Dakota St","Oral Roberts",1,2,0.666666666666667,3
"7768","N Dakota St","Rider",0,1,1,1
"7769","N Dakota St","Santa Clara",0,1,1,1
"7770","N Dakota St","S Dakota St",2,5,0.714285714285714,7
"7771","N Dakota St","South Dakota",1,5,0.833333333333333,6
"7772","N Dakota St","Southern Miss",2,0,0,2
"7773","N Dakota St","St Mary's CA",1,0,0,1
"7774","N Dakota St","Texas",1,0,0,1
"7775","N Dakota St","Towson",0,2,1,2
"7776","N Dakota St","Utah Valley",0,2,1,2
"7777","N Dakota St","WI Green Bay",1,0,0,1
"7778","N Dakota St","W Illinois",2,4,0.666666666666667,6
"7779","N Dakota St","W Michigan",0,1,1,1
"7780","N Dakota St","Youngstown St",0,1,1,1
"7781","N Dakota St","Mayville St",0,1,1,1
"7782","N Dakota St","Valley City St",0,1,1,1
"7783","N Dakota St","Viterbo",0,1,1,1
"7784","N Dakota St","MN Crookston",0,1,1,1
"7785","N Dakota St","Northland",0,1,1,1
"7786","Nebraska","Arkansas St",0,1,1,1
"7787","Nebraska","Cent Arkansas",0,1,1,1
"7788","Nebraska","Cincinnati",1,1,0.5,2
"7789","Nebraska","Citadel",0,1,1,1
"7790","Nebraska","C Michigan",0,1,1,1
"7791","Nebraska","Creighton",3,0,0,3
"7792","Nebraska","FL Gulf Coast",0,1,1,1
"7793","Nebraska","Florida St",0,1,1,1
"7794","Nebraska","Georgia",0,1,1,1
"7795","Nebraska","Hawaii",1,0,0,1
"7796","Nebraska","Illinois",4,2,0.333333333333333,6
"7797","Nebraska","Indiana",2,2,0.5,4
"7798","Nebraska","Iowa",4,1,0.2,5
"7799","Nebraska","Jacksonville St",0,1,1,1
"7800","Nebraska","Kent",1,0,0,1
"7801","Nebraska","Loy Marymount",0,1,1,1
"7802","Nebraska","Maryland",2,0,0,2
"7803","Nebraska","Massachusetts",1,0,0,1
"7804","Nebraska","Miami FL",0,1,1,1
"7805","Nebraska","Michigan",4,0,0,4
"7806","Nebraska","Michigan St",2,2,0.5,4
"7807","Nebraska","Minnesota",2,3,0.6,5
"7808","Nebraska","NE Omaha",0,2,1,2
"7809","Nebraska","Nicholls St",0,1,1,1
"7810","Nebraska","N Illinois",0,1,1,1
"7811","Nebraska","N Kentucky",0,1,1,1
"7812","Nebraska","Northwestern",0,4,1,4
"7813","Nebraska","Ohio",0,1,1,1
"7814","Nebraska","Ohio St",5,1,0.166666666666667,6
"7815","Nebraska","Oregon",1,0,0,1
"7816","Nebraska","Penn St",3,3,0.5,6
"7817","Nebraska","Purdue",3,1,0.25,4
"7818","Nebraska","Rhode Island",1,0,0,1
"7819","Nebraska","Rutgers",0,1,1,1
"7820","Nebraska","S Carolina St",0,1,1,1
"7821","Nebraska","Southern Univ",0,1,1,1
"7822","Nebraska","TN Martin",0,1,1,1
"7823","Nebraska","Tulane",0,1,1,1
"7824","Nebraska","UAB",1,0,0,1
"7825","Nebraska","USC",0,1,1,1
"7826","Nebraska","UTEP",1,0,0,1
"7827","Nebraska","Valparaiso",0,1,1,1
"7828","Nebraska","Wake Forest",0,1,1,1
"7829","Nebraska","W Illinois",0,1,1,1
"7830","Nebraska","Wisconsin",4,1,0.2,5
"7831","Nebraska","Incarnate Word",1,0,0,1
"7832","NE Omaha","Air Force",1,0,0,1
"7833","NE Omaha","Bethune-Cookman",1,0,0,1
"7834","NE Omaha","Cent Arkansas",0,2,1,2
"7835","NE Omaha","Chicago St",1,2,0.666666666666667,3
"7836","NE Omaha","CS Bakersfield",1,1,0.5,2
"7837","NE Omaha","Denver",4,1,0.2,5
"7838","NE Omaha","Drake",1,0,0,1
"7839","NE Omaha","Hawaii",1,0,0,1
"7840","NE Omaha","Iowa",1,0,0,1
"7841","NE Omaha","Iowa St",1,0,0,1
"7842","NE Omaha","IPFW",4,2,0.333333333333333,6
"7843","NE Omaha","IUPUI",1,5,0.833333333333333,6
"7844","NE Omaha","Kansas St",1,0,0,1
"7845","NE Omaha","Marquette",0,1,1,1
"7846","NE Omaha","Minnesota",1,0,0,1
"7847","NE Omaha","Missouri KC",1,3,0.75,4
"7848","NE Omaha","N Colorado",0,1,1,1
"7849","NE Omaha","N Dakota St",6,0,0,6
"7850","NE Omaha","Nebraska",2,0,0,2
"7851","NE Omaha","Nevada",0,2,1,2
"7852","NE Omaha","N Illinois",0,2,1,2
"7853","NE Omaha","North Dakota",0,2,1,2
"7854","NE Omaha","Oakland",2,0,0,2
"7855","NE Omaha","Oral Roberts",2,0,0,2
"7856","NE Omaha","S Carolina St",0,2,1,2
"7857","NE Omaha","S Dakota St",5,1,0.166666666666667,6
"7858","NE Omaha","Seattle",1,1,0.5,2
"7859","NE Omaha","South Dakota",3,3,0.5,6
"7860","NE Omaha","Texas Tech",1,0,0,1
"7861","NE Omaha","Tulane",1,0,0,1
"7862","NE Omaha","TX Pan American",1,1,0.5,2
"7863","NE Omaha","UNLV",1,0,0,1
"7864","NE Omaha","W Illinois",4,2,0.333333333333333,6
"7865","NE Omaha","Wisconsin",1,0,0,1
"7866","NE Omaha","Iowa Wesleyan",0,2,1,2
"7867","NE Omaha","Peru St",0,1,1,1
"7868","NE Omaha","Waldorf",0,1,1,1
"7869","Nevada","Air Force",2,4,0.666666666666667,6
"7870","Nevada","Boise St",4,2,0.333333333333333,6
"7871","Nevada","California",2,0,0,2
"7872","Nevada","Cal Poly SLO",0,3,1,3
"7873","Nevada","Chattanooga",0,1,1,1
"7874","Nevada","Clemson",1,0,0,1
"7875","Nevada","Colorado St",4,1,0.2,5
"7876","Nevada","CS Bakersfield",1,0,0,1
"7877","Nevada","CS Fullerton",1,1,0.5,2
"7878","Nevada","Drake",1,0,0,1
"7879","Nevada","Fresno St",4,2,0.333333333333333,6
"7880","Nevada","Iona",0,1,1,1
"7881","Nevada","Long Beach St",2,0,0,2
"7882","Nevada","Marshall",1,1,0.5,2
"7883","Nevada","Missouri",1,0,0,1
"7884","Nevada","Morehead St",1,0,0,1
"7885","Nevada","NE Omaha",2,0,0,2
"7886","Nevada","New Mexico",4,1,0.2,5
"7887","Nevada","Oregon",1,0,0,1
"7888","Nevada","Pacific",3,0,0,3
"7889","Nevada","San Diego St",5,0,0,5
"7890","Nevada","San Francisco",0,2,1,2
"7891","Nevada","San Jose St",1,3,0.75,4
"7892","Nevada","Seton Hall",1,0,0,1
"7893","Nevada","Southern Utah",0,1,1,1
"7894","Nevada","UC Davis",0,2,1,2
"7895","Nevada","UC Irvine",1,0,0,1
"7896","Nevada","UCLA",1,0,0,1
"7897","Nevada","UNLV",4,3,0.428571428571429,7
"7898","Nevada","Utah St",3,1,0.25,4
"7899","Nevada","Washington",0,1,1,1
"7900","Nevada","Weber St",1,0,0,1
"7901","Nevada","WI Green Bay",0,1,1,1
"7902","Nevada","Wyoming",5,1,0.166666666666667,6
"7903","Nevada","Yale",0,1,1,1
"7904","Nevada","Adams St",0,1,1,1
"7905","Nevada","Northwest Chr",0,1,1,1
"7906","New Hampshire","Albany NY",6,1,0.142857142857143,7
"7907","New Hampshire","Binghamton",2,4,0.666666666666667,6
"7908","New Hampshire","Boston College",2,0,0,2
"7909","New Hampshire","Boston Univ",2,1,0.333333333333333,3
"7910","New Hampshire","Brown",1,2,0.666666666666667,3
"7911","New Hampshire","Bryant",3,0,0,3
"7912","New Hampshire","Central Conn",2,0,0,2
"7913","New Hampshire","Colgate",1,1,0.5,2
"7914","New Hampshire","Connecticut",1,0,0,1
"7915","New Hampshire","Dartmouth",1,2,0.666666666666667,3
"7916","New Hampshire","Duquesne",0,1,1,1
"7917","New Hampshire","Hartford",5,2,0.285714285714286,7
"7918","New Hampshire","Holy Cross",2,0,0,2
"7919","New Hampshire","Long Island",1,1,0.5,2
"7920","New Hampshire","Maine",2,4,0.666666666666667,6
"7921","New Hampshire","Marquette",1,0,0,1
"7922","New Hampshire","MD Baltimore Co",1,1,0.5,2
"7923","New Hampshire","NJIT",2,0,0,2
"7924","New Hampshire","Penn St",1,0,0,1
"7925","New Hampshire","Rhode Island",1,0,0,1
"7926","New Hampshire","Rutgers",1,0,0,1
"7927","New Hampshire","Sacred Heart",2,0,0,2
"7928","New Hampshire","Stony Brook",4,2,0.333333333333333,6
"7929","New Hampshire","Towson",1,0,0,1
"7930","New Hampshire","Vermont",6,1,0.142857142857143,7
"7931","New Hampshire","W Michigan",1,0,0,1
"7932","New Hampshire","Yale",1,1,0.5,2
"7933","New Hampshire","MA Lowell",1,3,0.75,4
"7934","New Hampshire","Suffolk",0,1,1,1
"7935","New Hampshire","UMBC",1,3,0.75,4
"7936","New Hampshire","Wheelock",0,1,1,1
"7937","New Hampshire","Thomas ME",0,1,1,1
"7938","New Mexico","Air Force",3,3,0.5,6
"7939","New Mexico","Alabama A&M",0,1,1,1
"7940","New Mexico","Boise St",3,4,0.571428571428571,7
"7941","New Mexico","Boston College",1,0,0,1
"7942","New Mexico","Cent Arkansas",0,1,1,1
"7943","New Mexico","Charleston So",0,1,1,1
"7944","New Mexico","Cincinnati",0,2,1,2
"7945","New Mexico","Colorado St",1,5,0.833333333333333,6
"7946","New Mexico","Connecticut",0,1,1,1
"7947","New Mexico","CS Fullerton",0,1,1,1
"7948","New Mexico","Davidson",0,2,1,2
"7949","New Mexico","Fresno St",1,5,0.833333333333333,6
"7950","New Mexico","George Mason",0,2,1,2
"7951","New Mexico","Idaho",0,1,1,1
"7952","New Mexico","Idaho St",0,1,1,1
"7953","New Mexico","IL Chicago",0,1,1,1
"7954","New Mexico","Indiana St",0,1,1,1
"7955","New Mexico","Kansas",1,0,0,1
"7956","New Mexico","Marquette",0,1,1,1
"7957","New Mexico","Massachusetts",1,0,0,1
"7958","New Mexico","Mercer",0,1,1,1
"7959","New Mexico","Nevada",1,4,0.8,5
"7960","New Mexico","New Mexico St",1,5,0.833333333333333,6
"7961","New Mexico","Portland",0,1,1,1
"7962","New Mexico","San Diego",0,1,1,1
"7963","New Mexico","San Diego St",4,3,0.428571428571429,7
"7964","New Mexico","San Jose St",0,3,1,3
"7965","New Mexico","S Dakota St",1,0,0,1
"7966","New Mexico","St Louis",1,0,0,1
"7967","New Mexico","Texas A&M",1,0,0,1
"7968","New Mexico","UAB",0,1,1,1
"7969","New Mexico","ULM",0,1,1,1
"7970","New Mexico","UNLV",3,3,0.5,6
"7971","New Mexico","USC",1,1,0.5,2
"7972","New Mexico","Utah St",1,3,0.75,4
"7973","New Mexico","Valparaiso",0,2,1,2
"7974","New Mexico","Wyoming",1,5,0.833333333333333,6
"7975","New Mexico","Grand Canyon",1,1,0.5,2
"7976","New Mexico St","Arizona",1,0,0,1
"7977","New Mexico St","Baylor",1,0,0,1
"7978","New Mexico St","Bethune-Cookman",0,1,1,1
"7979","New Mexico St","Bucknell",1,0,0,1
"7980","New Mexico St","Chicago St",1,3,0.75,4
"7981","New Mexico St","Colorado St",2,0,0,2
"7982","New Mexico St","CS Bakersfield",0,6,1,6
"7983","New Mexico St","Denver",1,1,0.5,2
"7984","New Mexico St","Drake",0,1,1,1
"7985","New Mexico St","Florida A&M",0,1,1,1
"7986","New Mexico St","Gonzaga",1,0,0,1
"7987","New Mexico St","Hawaii",0,1,1,1
"7988","New Mexico St","Idaho",1,4,0.8,5
"7989","New Mexico St","Louisiana Tech",1,1,0.5,2
"7990","New Mexico St","Missouri KC",1,3,0.75,4
"7991","New Mexico St","Missouri St",0,1,1,1
"7992","New Mexico St","N Colorado",0,2,1,2
"7993","New Mexico St","New Mexico",5,1,0.166666666666667,6
"7994","New Mexico St","Niagara",1,0,0,1
"7995","New Mexico St","Oral Roberts",1,0,0,1
"7996","New Mexico St","Oregon St",1,0,0,1
"7997","New Mexico St","Prairie View",0,1,1,1
"7998","New Mexico St","San Jose St",0,2,1,2
"7999","New Mexico St","Seattle",1,7,0.875,8
"8000","New Mexico St","SE Louisiana",0,1,1,1
"8001","New Mexico St","South Alabama",0,2,1,2
"8002","New Mexico St","Southern Miss",0,1,1,1
"8003","New Mexico St","Stetson",0,1,1,1
"8004","New Mexico St","St Mary's CA",1,0,0,1
"8005","New Mexico St","Tennessee St",0,1,1,1
"8006","New Mexico St","Texas St",0,2,1,2
"8007","New Mexico St","TX Pan American",0,4,1,4
"8008","New Mexico St","TX Southern",0,1,1,1
"8009","New Mexico St","UC Irvine",0,1,1,1
"8010","New Mexico St","ULL",0,1,1,1
"8011","New Mexico St","Utah St",1,1,0.5,2
"8012","New Mexico St","Utah Valley",1,3,0.75,4
"8013","New Mexico St","UT Arlington",1,1,0.5,2
"8014","New Mexico St","UTEP",2,4,0.666666666666667,6
"8015","New Mexico St","UT San Antonio",0,2,1,2
"8016","New Mexico St","Wichita St",1,0,0,1
"8017","New Mexico St","W Michigan",1,0,0,1
"8018","New Mexico St","Wyoming",1,0,0,1
"8019","New Mexico St","Grand Canyon",0,4,1,4
"8020","New Mexico St","N New Mexico",0,2,1,2
"8021","New Mexico St","NM Highlands",0,1,1,1
"8022","New Orleans","Air Force",1,0,0,1
"8023","New Orleans","Bethune-Cookman",1,0,0,1
"8024","New Orleans","Boise St",2,0,0,2
"8025","New Orleans","Bowling Green",1,0,0,1
"8026","New Orleans","Butler",1,0,0,1
"8027","New Orleans","Cent Arkansas",1,2,0.666666666666667,3
"8028","New Orleans","Denver",1,0,0,1
"8029","New Orleans","Duquesne",1,0,0,1
"8030","New Orleans","Hawaii",1,0,0,1
"8031","New Orleans","Houston Bap",3,1,0.25,4
"8032","New Orleans","Indiana",1,0,0,1
"8033","New Orleans","Lamar",1,2,0.666666666666667,3
"8034","New Orleans","LSU",1,0,0,1
"8035","New Orleans","McNeese St",3,1,0.25,4
"8036","New Orleans","Michigan St",1,0,0,1
"8037","New Orleans","Minnesota",1,0,0,1
"8038","New Orleans","Mississippi St",1,0,0,1
"8039","New Orleans","Nicholls St",4,3,0.428571428571429,7
"8040","New Orleans","NJIT",1,1,0.5,2
"8041","New Orleans","Northwestern LA",3,0,0,3
"8042","New Orleans","Oral Roberts",1,0,0,1
"8043","New Orleans","Rice",1,0,0,1
"8044","New Orleans","Sam Houston St",3,0,0,3
"8045","New Orleans","San Diego",1,0,0,1
"8046","New Orleans","San Jose St",1,1,0.5,2
"8047","New Orleans","SE Louisiana",0,4,1,4
"8048","New Orleans","SE Missouri St",2,0,0,2
"8049","New Orleans","SF Austin",2,0,0,2
"8050","New Orleans","S Illinois",2,1,0.333333333333333,3
"8051","New Orleans","TAM C. Christi",3,1,0.25,4
"8052","New Orleans","TCU",1,0,0,1
"8053","New Orleans","Texas A&M",1,0,0,1
"8054","New Orleans","TX Pan American",1,1,0.5,2
"8055","New Orleans","UTEP",0,1,1,1
"8056","New Orleans","Abilene Chr",0,2,1,2
"8057","New Orleans","Central Bap",0,1,1,1
"8058","New Orleans","Champion Bap",0,1,1,1
"8059","New Orleans","Crowley's Ridge",0,1,1,1
"8060","New Orleans","Incarnate Word",2,0,0,2
"8061","New Orleans","Millsaps",0,1,1,1
"8062","New Orleans","Pensacola Chr",0,1,1,1
"8063","Niagara","Albany NY",0,1,1,1
"8064","Niagara","Arkansas St",2,0,0,2
"8065","Niagara","Brown",1,1,0.5,2
"8066","Niagara","Bucknell",1,0,0,1
"8067","Niagara","Buffalo",2,1,0.333333333333333,3
"8068","Niagara","Canisius",4,2,0.333333333333333,6
"8069","Niagara","C Michigan",1,0,0,1
"8070","Niagara","Davidson",1,1,0.5,2
"8071","Niagara","Fairfield",1,5,0.833333333333333,6
"8072","Niagara","Hartford",1,1,0.5,2
"8073","Niagara","Iona",5,1,0.166666666666667,6
"8074","Niagara","Kent",1,0,0,1
"8075","Niagara","Loyola MD",1,1,0.5,2
"8076","Niagara","Manhattan",3,3,0.5,6
"8077","Niagara","Marist",3,4,0.571428571428571,7
"8078","Niagara","Monmouth NJ",4,0,0,4
"8079","Niagara","New Mexico St",0,1,1,1
"8080","Niagara","Northwestern LA",1,1,0.5,2
"8081","Niagara","Notre Dame",1,0,0,1
"8082","Niagara","Oregon St",1,0,0,1
"8083","Niagara","Penn",2,0,0,2
"8084","Niagara","Pittsburgh",1,0,0,1
"8085","Niagara","Quinnipiac",4,1,0.2,5
"8086","Niagara","Rider",5,1,0.166666666666667,6
"8087","Niagara","SC Upstate",1,0,0,1
"8088","Niagara","Seton Hall",1,0,0,1
"8089","Niagara","Siena",5,2,0.285714285714286,7
"8090","Niagara","St Bonaventure",3,0,0,3
"8091","Niagara","St Francis PA",0,1,1,1
"8092","Niagara","St John's",1,0,0,1
"8093","Niagara","St Peter's",2,4,0.666666666666667,6
"8094","Niagara","Vermont",0,1,1,1
"8095","Niagara","W Carolina",1,0,0,1
"8096","Nicholls St","Auburn",1,0,0,1
"8097","Nicholls St","Cent Arkansas",1,4,0.8,5
"8098","Nicholls St","Houston Bap",0,3,1,3
"8099","Nicholls St","Indiana",1,0,0,1
"8100","Nicholls St","IUPUI",0,1,1,1
"8101","Nicholls St","Lamar",1,3,0.75,4
"8102","Nicholls St","Louisiana Tech",1,0,0,1
"8103","Nicholls St","McNeese St",2,4,0.666666666666667,6
"8104","Nicholls St","Memphis",1,0,0,1
"8105","Nicholls St","Michigan",1,0,0,1
"8106","Nicholls St","Michigan St",1,0,0,1
"8107","Nicholls St","Missouri",1,0,0,1
"8108","Nicholls St","Nebraska",1,0,0,1
"8109","Nicholls St","New Orleans",3,4,0.571428571428571,7
"8110","Nicholls St","North Texas",2,0,0,2
"8111","Nicholls St","Northwestern LA",5,1,0.166666666666667,6
"8112","Nicholls St","Oral Roberts",2,1,0.333333333333333,3
"8113","Nicholls St","Sam Houston St",2,2,0.5,4
"8114","Nicholls St","San Francisco",1,0,0,1
"8115","Nicholls St","SE Louisiana",4,3,0.428571428571429,7
"8116","Nicholls St","SF Austin",4,0,0,4
"8117","Nicholls St","S Illinois",1,0,0,1
"8118","Nicholls St","TAM C. Christi",4,1,0.2,5
"8119","Nicholls St","Troy",2,0,0,2
"8120","Nicholls St","Tulane",1,0,0,1
"8121","Nicholls St","UC Davis",1,0,0,1
"8122","Nicholls St","UCLA",1,0,0,1
"8123","Nicholls St","Utah St",1,0,0,1
"8124","Nicholls St","UT San Antonio",1,1,0.5,2
"8125","Nicholls St","Vanderbilt",1,0,0,1
"8126","Nicholls St","Wake Forest",1,0,0,1
"8127","Nicholls St","Wisconsin",1,0,0,1
"8128","Nicholls St","Abilene Chr",1,1,0.5,2
"8129","Nicholls St","Incarnate Word",3,0,0,3
"8130","Nicholls St","Loyola NO",0,2,1,2
"8131","Nicholls St","Spring Hill",0,1,1,1
"8132","Nicholls St","Ark Monticello",0,1,1,1
"8133","N Illinois","Akron",3,1,0.25,4
"8134","N Illinois","Ball St",2,4,0.666666666666667,6
"8135","N Illinois","Bethune-Cookman",0,1,1,1
"8136","N Illinois","Bowling Green",3,2,0.4,5
"8137","N Illinois","Buffalo",4,0,0,4
"8138","N Illinois","C Michigan",3,3,0.5,6
"8139","N Illinois","Dartmouth",1,1,0.5,2
"8140","N Illinois","Dayton",1,0,0,1
"8141","N Illinois","DePaul",2,0,0,2
"8142","N Illinois","Edwardsville",0,1,1,1
"8143","N Illinois","E Illinois",2,0,0,2
"8144","N Illinois","E Michigan",6,1,0.142857142857143,7
"8145","N Illinois","Hampton",0,1,1,1
"8146","N Illinois","Idaho",0,1,1,1
"8147","N Illinois","IL Chicago",1,0,0,1
"8148","N Illinois","Iowa",1,0,0,1
"8149","N Illinois","Iowa St",1,0,0,1
"8150","N Illinois","James Madison",1,0,0,1
"8151","N Illinois","Kent",2,2,0.5,4
"8152","N Illinois","Loyola-Chicago",1,1,0.5,2
"8153","N Illinois","Maine",0,1,1,1
"8154","N Illinois","Massachusetts",2,0,0,2
"8155","N Illinois","Miami OH",1,3,0.75,4
"8156","N Illinois","MS Valley St",0,1,1,1
"8157","N Illinois","Nebraska",1,0,0,1
"8158","N Illinois","NE Omaha",2,0,0,2
"8159","N Illinois","Notre Dame",1,0,0,1
"8160","N Illinois","Ohio",2,1,0.333333333333333,3
"8161","N Illinois","San Jose St",0,1,1,1
"8162","N Illinois","Seattle",1,0,0,1
"8163","N Illinois","Toledo",4,2,0.333333333333333,6
"8164","N Illinois","UC Riverside",0,2,1,2
"8165","N Illinois","Valparaiso",1,0,0,1
"8166","N Illinois","Washington",1,0,0,1
"8167","N Illinois","WI Milwaukee",2,0,0,2
"8168","N Illinois","W Michigan",5,1,0.166666666666667,6
"8169","N Illinois","St Joseph's IN",0,1,1,1
"8170","N Illinois","Aurora",0,1,1,1
"8171","NJIT","Albany NY",4,0,0,4
"8172","NJIT","Army",0,2,1,2
"8173","NJIT","Butler",1,0,0,1
"8174","NJIT","Central Conn",1,1,0.5,2
"8175","NJIT","Chicago St",0,2,1,2
"8176","NJIT","Colgate",0,1,1,1
"8177","NJIT","Dartmouth",1,0,0,1
"8178","NJIT","Delaware St",0,2,1,2
"8179","NJIT","Duquesne",1,1,0.5,2
"8180","NJIT","F Dickinson",0,1,1,1
"8181","NJIT","Hampton",0,1,1,1
"8182","NJIT","Hofstra",1,0,0,1
"8183","NJIT","Holy Cross",2,0,0,2
"8184","NJIT","Houston Bap",1,1,0.5,2
"8185","NJIT","Howard",0,1,1,1
"8186","NJIT","Lafayette",2,1,0.333333333333333,3
"8187","NJIT","Long Island",2,0,0,2
"8188","NJIT","Maine",0,4,1,4
"8189","NJIT","Marquette",1,0,0,1
"8190","NJIT","MD E Shore",0,2,1,2
"8191","NJIT","Michigan",0,1,1,1
"8192","NJIT","NC A&T",2,0,0,2
"8193","NJIT","NC Central",2,0,0,2
"8194","NJIT","New Hampshire",0,2,1,2
"8195","NJIT","New Orleans",1,1,0.5,2
"8196","NJIT","Penn",2,0,0,2
"8197","NJIT","Providence",1,0,0,1
"8198","NJIT","S Carolina St",1,1,0.5,2
"8199","NJIT","Seton Hall",2,0,0,2
"8200","NJIT","South Alabama",0,1,1,1
"8201","NJIT","St Francis NY",2,1,0.333333333333333,3
"8202","NJIT","St Francis PA",0,2,1,2
"8203","NJIT","St John's",2,0,0,2
"8204","NJIT","Tulane",1,0,0,1
"8205","NJIT","TX Pan American",1,1,0.5,2
"8206","NJIT","Utah Valley",0,2,1,2
"8207","NJIT","Villanova",2,0,0,2
"8208","NJIT","Yale",0,1,1,1
"8209","NJIT","City Col NY",0,1,1,1
"8210","NJIT","Fisher",0,2,1,2
"8211","NJIT","MA Lowell",3,1,0.25,4
"8212","NJIT","ME Ft Kent",0,2,1,2
"8213","NJIT","UMBC",0,1,1,1
"8214","NJIT","Wheelock",0,1,1,1
"8215","NJIT","Sarah Lawrence",0,1,1,1
"8216","NJIT","St Joseph's NY",0,1,1,1
"8217","N Kentucky","Chattanooga",1,1,0.5,2
"8218","N Kentucky","CS Northridge",1,0,0,1
"8219","N Kentucky","ETSU",3,1,0.25,4
"8220","N Kentucky","E Washington",1,0,0,1
"8221","N Kentucky","FL Gulf Coast",6,0,0,6
"8222","N Kentucky","Hampton",0,2,1,2
"8223","N Kentucky","Idaho",0,2,1,2
"8224","N Kentucky","Jacksonville",3,3,0.5,6
"8225","N Kentucky","Kennesaw",1,5,0.833333333333333,6
"8226","N Kentucky","Kentucky",1,0,0,1
"8227","N Kentucky","Lipscomb",5,2,0.285714285714286,7
"8228","N Kentucky","Mercer",3,1,0.25,4
"8229","N Kentucky","Morehead St",1,1,0.5,2
"8230","N Kentucky","Navy",0,2,1,2
"8231","N Kentucky","NC A&T",0,1,1,1
"8232","N Kentucky","Nebraska",1,0,0,1
"8233","N Kentucky","North Carolina",1,0,0,1
"8234","N Kentucky","North Florida",3,3,0.5,6
"8235","N Kentucky","Northwestern",1,0,0,1
"8236","N Kentucky","Ohio St",1,0,0,1
"8237","N Kentucky","Purdue",1,0,0,1
"8238","N Kentucky","San Diego",2,0,0,2
"8239","N Kentucky","SC Upstate",3,3,0.5,6
"8240","N Kentucky","SE Missouri St",1,0,0,1
"8241","N Kentucky","Siena",1,0,0,1
"8242","N Kentucky","Stetson",3,3,0.5,6
"8243","N Kentucky","Texas St",1,0,0,1
"8244","N Kentucky","Texas Tech",1,0,0,1
"8245","N Kentucky","TN Martin",2,0,0,2
"8246","N Kentucky","Toledo",1,0,0,1
"8247","N Kentucky","Tulane",0,1,1,1
"8248","N Kentucky","Tulsa",1,0,0,1
"8249","N Kentucky","West Virginia",1,0,0,1
"8250","N Kentucky","Wisconsin",1,0,0,1
"8251","N Kentucky","Youngstown St",1,0,0,1
"8252","N Kentucky","Cin Clermont",0,1,1,1
"8253","N Kentucky","Ohio Mid-Western",0,1,1,1
"8254","Norfolk St","Ball St",1,0,0,1
"8255","Norfolk St","Baylor",1,0,0,1
"8256","Norfolk St","Bethune-Cookman",0,3,1,3
"8257","Norfolk St","Boston Univ",1,1,0.5,2
"8258","Norfolk St","Coppin St",0,6,1,6
"8259","Norfolk St","Delaware St",0,4,1,4
"8260","Norfolk St","East Carolina",2,0,0,2
"8261","Norfolk St","E Kentucky",1,0,0,1
"8262","Norfolk St","F Dickinson",0,1,1,1
"8263","Norfolk St","Florida A&M",0,3,1,3
"8264","Norfolk St","Georgia",1,0,0,1
"8265","Norfolk St","Hampton",3,4,0.571428571428571,7
"8266","Norfolk St","Hawaii",1,0,0,1
"8267","Norfolk St","Hofstra",1,0,0,1
"8268","Norfolk St","Howard",1,4,0.8,5
"8269","Norfolk St","Illinois",1,0,0,1
"8270","Norfolk St","Iona",1,0,0,1
"8271","Norfolk St","James Madison",0,1,1,1
"8272","Norfolk St","Long Island",1,0,0,1
"8273","Norfolk St","Longwood",0,1,1,1
"8274","Norfolk St","Loyola MD",1,0,0,1
"8275","Norfolk St","MD Baltimore Co",0,1,1,1
"8276","Norfolk St","MD E Shore",1,5,0.833333333333333,6
"8277","Norfolk St","Miami FL",1,0,0,1
"8278","Norfolk St","Missouri KC",1,0,0,1
"8279","Norfolk St","Morehead St",1,0,0,1
"8280","Norfolk St","Morgan St",2,4,0.666666666666667,6
"8281","Norfolk St","Mt St Mary's",2,0,0,2
"8282","Norfolk St","Navy",0,1,1,1
"8283","Norfolk St","NC A&T",0,2,1,2
"8284","Norfolk St","NC Central",3,0,0,3
"8285","Norfolk St","NC State",1,0,0,1
"8286","Norfolk St","Northern Arizona",0,1,1,1
"8287","Norfolk St","Princeton",1,0,0,1
"8288","Norfolk St","Rhode Island",0,1,1,1
"8289","Norfolk St","Savannah St",0,4,1,4
"8290","Norfolk St","S Carolina St",1,3,0.75,4
"8291","Norfolk St","Seattle",1,0,0,1
"8292","Norfolk St","Seton Hall",1,0,0,1
"8293","Norfolk St","St Francis NY",0,2,1,2
"8294","Norfolk St","St Peter's",0,1,1,1
"8295","Norfolk St","TX Southern",1,1,0.5,2
"8296","Norfolk St","UNC Asheville",0,1,1,1
"8297","Norfolk St","Vanderbilt",1,0,0,1
"8298","Norfolk St","Virginia",2,0,0,2
"8299","Norfolk St","Newberry",0,1,1,1
"8300","Norfolk St","Stillman",0,1,1,1
"8301","Norfolk St","Virginia Union",0,1,1,1
"8302","Norfolk St","Pfeiffer",0,1,1,1
"8303","Norfolk St","UVA-Wise",0,1,1,1
"8304","North Carolina","Belmont",1,0,0,1
"8305","North Carolina","Boston College",0,4,1,4
"8306","North Carolina","Butler",2,0,0,2
"8307","North Carolina","Clemson",0,3,1,3
"8308","North Carolina","Davidson",0,2,1,2
"8309","North Carolina","Duke",5,1,0.166666666666667,6
"8310","North Carolina","East Carolina",0,2,1,2
"8311","North Carolina","ETSU",0,1,1,1
"8312","North Carolina","FL Atlantic",0,1,1,1
"8313","North Carolina","Florida",0,1,1,1
"8314","North Carolina","Florida St",0,4,1,4
"8315","North Carolina","Gardner Webb",0,1,1,1
"8316","North Carolina","Georgia Tech",0,5,1,5
"8317","North Carolina","Holy Cross",0,1,1,1
"8318","North Carolina","Indiana",1,0,0,1
"8319","North Carolina","Iowa",1,0,0,1
"8320","North Carolina","Kentucky",1,1,0.5,2
"8321","North Carolina","Long Beach St",0,1,1,1
"8322","North Carolina","Louisville",1,3,0.75,4
"8323","North Carolina","Maryland",0,3,1,3
"8324","North Carolina","McNeese St",0,1,1,1
"8325","North Carolina","Miami FL",3,1,0.25,4
"8326","North Carolina","Michigan St",0,1,1,1
"8327","North Carolina","Mississippi St",0,1,1,1
"8328","North Carolina","NC Central",0,1,1,1
"8329","North Carolina","NC State",2,4,0.666666666666667,6
"8330","North Carolina","N Kentucky",0,1,1,1
"8331","North Carolina","Notre Dame",2,2,0.5,4
"8332","North Carolina","Oakland",0,1,1,1
"8333","North Carolina","Ohio St",0,1,1,1
"8334","North Carolina","Pittsburgh",2,1,0.333333333333333,3
"8335","North Carolina","Richmond",0,1,1,1
"8336","North Carolina","Robert Morris",0,1,1,1
"8337","North Carolina","Syracuse",1,1,0.5,2
"8338","North Carolina","Texas",2,0,0,2
"8339","North Carolina","UAB",1,2,0.666666666666667,3
"8340","North Carolina","UCLA",0,1,1,1
"8341","North Carolina","UNC Greensboro",0,2,1,2
"8342","North Carolina","UNC Wilmington",0,1,1,1
"8343","North Carolina","UNLV",0,1,1,1
"8344","North Carolina","Virginia",3,2,0.4,5
"8345","North Carolina","Virginia Tech",0,3,1,3
"8346","North Carolina","Wake Forest",1,3,0.75,4
"8347","North Carolina","William & Mary",0,1,1,1
"8348","North Dakota","Alabama St",0,1,1,1
"8349","North Dakota","Bowling Green",1,1,0.5,2
"8350","North Dakota","Butler",1,0,0,1
"8351","North Dakota","Cal Poly SLO",1,0,0,1
"8352","North Dakota","CS Sacramento",4,3,0.428571428571429,7
"8353","North Dakota","Drake",0,1,1,1
"8354","North Dakota","E Washington",1,4,0.8,5
"8355","North Dakota","Hawaii",1,0,0,1
"8356","North Dakota","Idaho",0,1,1,1
"8357","North Dakota","Idaho St",0,5,1,5
"8358","North Dakota","Kansas St",1,0,0,1
"8359","North Dakota","Marquette",1,0,0,1
"8360","North Dakota","Minnesota",1,0,0,1
"8361","North Dakota","Missouri KC",1,0,0,1
"8362","North Dakota","Montana",5,1,0.166666666666667,6
"8363","North Dakota","Montana St",2,4,0.666666666666667,6
"8364","North Dakota","N Colorado",4,2,0.333333333333333,6
"8365","North Dakota","N Dakota St",2,1,0.333333333333333,3
"8366","North Dakota","NE Omaha",2,0,0,2
"8367","North Dakota","Northern Arizona",3,3,0.5,6
"8368","North Dakota","Northern Iowa",2,0,0,2
"8369","North Dakota","Oregon",1,0,0,1
"8370","North Dakota","Pacific",1,0,0,1
"8371","North Dakota","Portland St",3,4,0.571428571428571,7
"8372","North Dakota","S Dakota St",3,0,0,3
"8373","North Dakota","Southern Utah",3,3,0.5,6
"8374","North Dakota","TX Pan American",1,0,0,1
"8375","North Dakota","Utah",1,0,0,1
"8376","North Dakota","Weber St",6,0,0,6
"8377","North Dakota","Wisconsin",1,0,0,1
"8378","North Dakota","Mayville St",0,1,1,1
"8379","North Dakota","MN Morris",0,1,1,1
"8380","North Dakota","Presentation",0,1,1,1
"8381","North Dakota","Dickinson St ND",0,1,1,1
"8382","Northeastern","Belmont",0,1,1,1
"8383","Northeastern","Boston Univ",1,2,0.666666666666667,3
"8384","Northeastern","Cal Poly SLO",1,0,0,1
"8385","Northeastern","Central Conn",0,2,1,2
"8386","Northeastern","Charlotte",2,0,0,2
"8387","Northeastern","Col Charleston",1,3,0.75,4
"8388","Northeastern","Delaware",5,3,0.375,8
"8389","Northeastern","Detroit",1,0,0,1
"8390","Northeastern","Drexel",2,5,0.714285714285714,7
"8391","Northeastern","Elon",1,1,0.5,2
"8392","Northeastern","Fairfield",1,1,0.5,2
"8393","Northeastern","Florida St",1,1,0.5,2
"8394","Northeastern","George Mason",0,2,1,2
"8395","Northeastern","Georgetown",0,1,1,1
"8396","Northeastern","Georgia St",1,1,0.5,2
"8397","Northeastern","Harvard",2,0,0,2
"8398","Northeastern","Hofstra",0,6,1,6
"8399","Northeastern","James Madison",1,4,0.8,5
"8400","Northeastern","La Salle",1,0,0,1
"8401","Northeastern","Maine",1,0,0,1
"8402","Northeastern","Manhattan",0,1,1,1
"8403","Northeastern","Massachusetts",2,0,0,2
"8404","Northeastern","Navy",0,1,1,1
"8405","Northeastern","Old Dominion",1,1,0.5,2
"8406","Northeastern","Princeton",0,1,1,1
"8407","Northeastern","Richmond",1,1,0.5,2
"8408","Northeastern","Santa Clara",0,1,1,1
"8409","Northeastern","St Mary's CA",1,0,0,1
"8410","Northeastern","Stony Brook",1,0,0,1
"8411","Northeastern","Towson",1,4,0.8,5
"8412","Northeastern","Tulane",1,0,0,1
"8413","Northeastern","UAB",2,0,0,2
"8414","Northeastern","UC Riverside",0,1,1,1
"8415","Northeastern","UNC Asheville",1,0,0,1
"8416","Northeastern","UNC Wilmington",4,3,0.428571428571429,7
"8417","Northeastern","VA Commonwealth",1,0,0,1
"8418","Northeastern","Vanderbilt",1,0,0,1
"8419","Northeastern","Vermont",1,0,0,1
"8420","Northeastern","William & Mary",3,4,0.571428571428571,7
"8421","Northeastern","WI Milwaukee",0,1,1,1
"8422","Northeastern","W Michigan",0,1,1,1
"8423","Northern Arizona","Arizona",2,0,0,2
"8424","Northern Arizona","BYU",1,0,0,1
"8425","Northern Arizona","Campbell",0,1,1,1
"8426","Northern Arizona","Colorado",1,0,0,1
"8427","Northern Arizona","CS Bakersfield",1,0,0,1
"8428","Northern Arizona","CS Sacramento",2,4,0.666666666666667,6
"8429","Northern Arizona","Drake",1,0,0,1
"8430","Northern Arizona","E Washington",3,2,0.4,5
"8431","Northern Arizona","Fresno St",1,1,0.5,2
"8432","Northern Arizona","Hampton",1,0,0,1
"8433","Northern Arizona","Hawaii",2,0,0,2
"8434","Northern Arizona","Idaho",0,1,1,1
"8435","Northern Arizona","Idaho St",1,5,0.833333333333333,6
"8436","Northern Arizona","Jacksonville St",1,0,0,1
"8437","Northern Arizona","Loy Marymount",2,1,0.333333333333333,3
"8438","Northern Arizona","Mississippi",1,0,0,1
"8439","Northern Arizona","Montana",4,2,0.333333333333333,6
"8440","Northern Arizona","Montana St",2,3,0.6,5
"8441","Northern Arizona","NC Central",1,0,0,1
"8442","Northern Arizona","N Colorado",5,3,0.375,8
"8443","Northern Arizona","Norfolk St",1,0,0,1
"8444","Northern Arizona","North Dakota",3,3,0.5,6
"8445","Northern Arizona","Oregon",1,0,0,1
"8446","Northern Arizona","Portland St",1,5,0.833333333333333,6
"8447","Northern Arizona","Sam Houston St",0,1,1,1
"8448","Northern Arizona","Southern Univ",0,1,1,1
"8449","Northern Arizona","Southern Utah",2,4,0.666666666666667,6
"8450","Northern Arizona","St Mary's CA",0,1,1,1
"8451","Northern Arizona","Texas Tech",1,0,0,1
"8452","Northern Arizona","Toledo",1,0,0,1
"8453","Northern Arizona","UC Davis",0,1,1,1
"8454","Northern Arizona","UNLV",1,0,0,1
"8455","Northern Arizona","USC",1,0,0,1
"8456","Northern Arizona","UT San Antonio",1,1,0.5,2
"8457","Northern Arizona","Weber St",4,2,0.333333333333333,6
"8458","Northern Arizona","Xavier",1,0,0,1
"8459","Northern Arizona","Grand Canyon",0,1,1,1
"8460","Northern Arizona","San Diego Chr",0,2,1,2
"8461","Northern Arizona","MTSU",1,0,0,1
"8462","Northern Iowa","Bradley",1,6,0.857142857142857,7
"8463","Northern Iowa","Creighton",1,1,0.5,2
"8464","Northern Iowa","Denver",1,1,0.5,2
"8465","Northern Iowa","Drake",1,5,0.833333333333333,6
"8466","Northern Iowa","Evansville",3,3,0.5,6
"8467","Northern Iowa","George Mason",1,2,0.666666666666667,3
"8468","Northern Iowa","Illinois St",1,6,0.857142857142857,7
"8469","Northern Iowa","Indiana St",3,3,0.5,6
"8470","Northern Iowa","Iona",0,1,1,1
"8471","Northern Iowa","Iowa",1,1,0.5,2
"8472","Northern Iowa","Iowa St",1,0,0,1
"8473","Northern Iowa","La Salle",0,1,1,1
"8474","Northern Iowa","Louisville",1,0,0,1
"8475","Northern Iowa","Loy Marymount",0,1,1,1
"8476","Northern Iowa","Loyola-Chicago",1,4,0.8,5
"8477","Northern Iowa","Maryland",1,0,0,1
"8478","Northern Iowa","Memphis",1,0,0,1
"8479","Northern Iowa","Missouri St",0,6,1,6
"8480","Northern Iowa","Morgan St",0,1,1,1
"8481","Northern Iowa","N Colorado",0,1,1,1
"8482","Northern Iowa","North Dakota",0,2,1,2
"8483","Northern Iowa","North Florida",0,1,1,1
"8484","Northern Iowa","Northwestern",0,1,1,1
"8485","Northern Iowa","Ohio",1,0,0,1
"8486","Northern Iowa","Richmond",0,1,1,1
"8487","Northern Iowa","Savannah St",0,1,1,1
"8488","Northern Iowa","S Dakota St",0,1,1,1
"8489","Northern Iowa","SF Austin",0,1,1,1
"8490","Northern Iowa","S Illinois",3,4,0.571428571428571,7
"8491","Northern Iowa","Stanford",1,0,0,1
"8492","Northern Iowa","St Mary's CA",0,1,1,1
"8493","Northern Iowa","Toledo",0,1,1,1
"8494","Northern Iowa","UNLV",1,0,0,1
"8495","Northern Iowa","VA Commonwealth",1,1,0.5,2
"8496","Northern Iowa","Virginia",1,0,0,1
"8497","Northern Iowa","Virginia Tech",0,1,1,1
"8498","Northern Iowa","Wichita St",4,2,0.333333333333333,6
"8499","Northern Iowa","WI Milwaukee",1,1,0.5,2
"8500","Northern Iowa","Coe",0,1,1,1
"8501","North Florida","Alabama",2,0,0,2
"8502","North Florida","Ark Little Rock",0,1,1,1
"8503","North Florida","Austin Peay",1,0,0,1
"8504","North Florida","Bethune-Cookman",0,3,1,3
"8505","North Florida","Colorado St",1,0,0,1
"8506","North Florida","CS Bakersfield",0,1,1,1
"8507","North Florida","Elon",0,1,1,1
"8508","North Florida","ETSU",3,1,0.25,4
"8509","North Florida","FL Gulf Coast",4,2,0.333333333333333,6
"8510","North Florida","Florida",1,0,0,1
"8511","North Florida","Florida A&M",0,2,1,2
"8512","North Florida","Florida St",2,0,0,2
"8513","North Florida","Ga Southern",0,1,1,1
"8514","North Florida","Indiana",1,0,0,1
"8515","North Florida","Iowa",1,0,0,1
"8516","North Florida","Jacksonville",2,4,0.666666666666667,6
"8517","North Florida","Kansas St",1,0,0,1
"8518","North Florida","Kennesaw",0,6,1,6
"8519","North Florida","Liberty",0,1,1,1
"8520","North Florida","Lipscomb",1,6,0.857142857142857,7
"8521","North Florida","Memphis",1,0,0,1
"8522","North Florida","Mercer",2,2,0.5,4
"8523","North Florida","Michigan St",1,0,0,1
"8524","North Florida","Middle Tenn St",1,0,0,1
"8525","North Florida","Minnesota",1,0,0,1
"8526","North Florida","N Kentucky",3,3,0.5,6
"8527","North Florida","Northern Iowa",1,0,0,1
"8528","North Florida","Northwestern",1,0,0,1
"8529","North Florida","Ohio St",1,0,0,1
"8530","North Florida","Pittsburgh",1,0,0,1
"8531","North Florida","Portland",1,0,0,1
"8532","North Florida","Purdue",0,1,1,1
"8533","North Florida","Savannah St",1,2,0.666666666666667,3
"8534","North Florida","SC Upstate",6,2,0.25,8
"8535","North Florida","South Carolina",1,0,0,1
"8536","North Florida","Southern Univ",1,0,0,1
"8537","North Florida","Stetson",0,7,1,7
"8538","North Florida","Tennessee Tech",2,0,0,2
"8539","North Florida","Edward Waters",0,2,1,2
"8540","North Florida","Trinity Bap",0,1,1,1
"8541","North Florida","Webber",0,2,1,2
"8542","North Texas","Arkansas",1,0,0,1
"8543","North Texas","Arkansas St",1,1,0.5,2
"8544","North Texas","Ark Little Rock",2,0,0,2
"8545","North Texas","BYU",1,0,0,1
"8546","North Texas","Cent Arkansas",0,1,1,1
"8547","North Texas","Charlotte",2,1,0.333333333333333,3
"8548","North Texas","Columbia",1,0,0,1
"8549","North Texas","Creighton",1,1,0.5,2
"8550","North Texas","Delaware St",0,1,1,1
"8551","North Texas","East Carolina",0,1,1,1
"8552","North Texas","FL Atlantic",0,4,1,4
"8553","North Texas","Florida Intl",1,3,0.75,4
"8554","North Texas","Idaho",1,0,0,1
"8555","North Texas","Iona",1,0,0,1
"8556","North Texas","IUPUI",0,1,1,1
"8557","North Texas","Jackson St",0,1,1,1
"8558","North Texas","Lamar",0,1,1,1
"8559","North Texas","Lehigh",1,0,0,1
"8560","North Texas","Louisiana Tech",1,1,0.5,2
"8561","North Texas","Marshall",1,1,0.5,2
"8562","North Texas","Middle Tenn St",3,0,0,3
"8563","North Texas","MS Valley St",0,1,1,1
"8564","North Texas","Nicholls St",0,2,1,2
"8565","North Texas","Oklahoma",1,0,0,1
"8566","North Texas","Oklahoma St",1,0,0,1
"8567","North Texas","Old Dominion",3,0,0,3
"8568","North Texas","Portland",0,1,1,1
"8569","North Texas","Prairie View",1,0,0,1
"8570","North Texas","Rice",2,3,0.6,5
"8571","North Texas","SE Louisiana",0,2,1,2
"8572","North Texas","SF Austin",2,0,0,2
"8573","North Texas","South Alabama",1,1,0.5,2
"8574","North Texas","Southern Miss",2,0,0,2
"8575","North Texas","St Louis",1,0,0,1
"8576","North Texas","Texas A&M",0,1,1,1
"8577","North Texas","Texas Tech",1,0,0,1
"8578","North Texas","Troy",0,2,1,2
"8579","North Texas","Tulane",2,0,0,2
"8580","North Texas","Tulsa",2,0,0,2
"8581","North Texas","UAB",0,2,1,2
"8582","North Texas","UC Riverside",0,1,1,1
"8583","North Texas","ULL",2,0,0,2
"8584","North Texas","ULM",2,0,0,2
"8585","North Texas","UT Arlington",1,0,0,1
"8586","North Texas","UTEP",3,0,0,3
"8587","North Texas","UT San Antonio",2,1,0.333333333333333,3
"8588","North Texas","Virginia",1,0,0,1
"8589","North Texas","W Kentucky",3,0,0,3
"8590","North Texas","Incarnate Word",0,1,1,1
"8591","North Texas","Northwood TX",0,1,1,1
"8592","North Texas","Wayland",0,1,1,1
"8593","North Texas","Ark Monticello",0,1,1,1
"8594","North Texas","Langston",0,1,1,1
"8595","North Texas","MTSU",0,1,1,1
"8596","Northwestern","Baylor",0,1,1,1
"8597","Northwestern","Brown",0,3,1,3
"8598","Northwestern","Butler",2,0,0,2
"8599","Northwestern","C Michigan",1,0,0,1
"8600","Northwestern","Delaware St",0,1,1,1
"8601","Northwestern","DePaul",1,0,0,1
"8602","Northwestern","E Illinois",0,1,1,1
"8603","Northwestern","Elon",0,1,1,1
"8604","Northwestern","F Dickinson",0,1,1,1
"8605","Northwestern","Gardner Webb",0,1,1,1
"8606","Northwestern","Georgia Tech",1,0,0,1
"8607","Northwestern","Houston Bap",0,1,1,1
"8608","Northwestern","IL Chicago",1,2,0.666666666666667,3
"8609","Northwestern","Illinois",3,2,0.4,5
"8610","Northwestern","Illinois St",1,1,0.5,2
"8611","Northwestern","Indiana",3,2,0.4,5
"8612","Northwestern","Iowa",5,2,0.285714285714286,7
"8613","Northwestern","IUPUI",0,1,1,1
"8614","Northwestern","Maryland",2,0,0,2
"8615","Northwestern","Miami OH",0,1,1,1
"8616","Northwestern","Michigan",4,1,0.2,5
"8617","Northwestern","Michigan St",6,0,0,6
"8618","Northwestern","Minnesota",2,3,0.6,5
"8619","Northwestern","Missouri",1,0,0,1
"8620","Northwestern","MS Valley St",0,3,1,3
"8621","Northwestern","NC State",1,0,0,1
"8622","Northwestern","Nebraska",4,0,0,4
"8623","Northwestern","N Kentucky",0,1,1,1
"8624","Northwestern","Northern Iowa",1,0,0,1
"8625","Northwestern","North Florida",0,1,1,1
"8626","Northwestern","Ohio St",4,0,0,4
"8627","Northwestern","Penn St",2,2,0.5,4
"8628","Northwestern","Purdue",2,3,0.6,5
"8629","Northwestern","Rutgers",0,1,1,1
"8630","Northwestern","Stanford",2,0,0,2
"8631","Northwestern","TCU",0,1,1,1
"8632","Northwestern","Texas St",0,1,1,1
"8633","Northwestern","TX Southern",0,1,1,1
"8634","Northwestern","UCLA",1,0,0,1
"8635","Northwestern","Wisconsin",4,1,0.2,5
"8636","Northwestern","W Michigan",0,2,1,2
"8637","Northwestern LA","Arkansas",2,0,0,2
"8638","Northwestern LA","Auburn",0,1,1,1
"8639","Northwestern LA","Baylor",1,0,0,1
"8640","Northwestern LA","Campbell",0,1,1,1
"8641","Northwestern LA","Cent Arkansas",0,6,1,6
"8642","Northwestern LA","Houston Bap",1,1,0.5,2
"8643","Northwestern LA","Lamar",0,5,1,5
"8644","Northwestern LA","Louisiana Tech",2,1,0.333333333333333,3
"8645","Northwestern LA","LSU",2,0,0,2
"8646","Northwestern LA","McNeese St",0,6,1,6
"8647","Northwestern LA","Memphis",1,0,0,1
"8648","Northwestern LA","New Orleans",0,3,1,3
"8649","Northwestern LA","Niagara",1,1,0.5,2
"8650","Northwestern LA","Nicholls St",1,5,0.833333333333333,6
"8651","Northwestern LA","Oklahoma",2,0,0,2
"8652","Northwestern LA","Oral Roberts",1,3,0.75,4
"8653","Northwestern LA","Sam Houston St",3,2,0.4,5
"8654","Northwestern LA","SE Louisiana",0,5,1,5
"8655","Northwestern LA","SF Austin",7,1,0.125,8
"8656","Northwestern LA","TAM C. Christi",2,2,0.5,4
"8657","Northwestern LA","Texas A&M",2,0,0,2
"8658","Northwestern LA","Texas Tech",1,0,0,1
"8659","Northwestern LA","ULL",1,1,0.5,2
"8660","Northwestern LA","ULM",2,0,0,2
"8661","Northwestern LA","UTEP",1,0,0,1
"8662","Northwestern LA","Abilene Chr",1,1,0.5,2
"8663","Northwestern LA","Incarnate Word",0,2,1,2
"8664","Northwestern LA","Le Tourneau",0,1,1,1
"8665","Northwestern LA","Louisiana Col",0,2,1,2
"8666","Northwestern LA","Lyon",0,1,1,1
"8667","Northwestern LA","LSU-Alexandria",0,1,1,1
"8668","Northwestern LA","Missouri Val",0,1,1,1
"8669","Notre Dame","Army",0,1,1,1
"8670","Notre Dame","Binghamton",0,1,1,1
"8671","Notre Dame","Boston College",0,4,1,4
"8672","Notre Dame","Brown",0,1,1,1
"8673","Notre Dame","Bryant",0,1,1,1
"8674","Notre Dame","BYU",0,1,1,1
"8675","Notre Dame","Canisius",0,1,1,1
"8676","Notre Dame","Chicago St",0,2,1,2
"8677","Notre Dame","Cincinnati",0,2,1,2
"8678","Notre Dame","Clemson",0,3,1,3
"8679","Notre Dame","Connecticut",1,0,0,1
"8680","Notre Dame","Coppin St",0,1,1,1
"8681","Notre Dame","Cornell",0,1,1,1
"8682","Notre Dame","Delaware",0,1,1,1
"8683","Notre Dame","DePaul",0,2,1,2
"8684","Notre Dame","Duke",1,3,0.75,4
"8685","Notre Dame","Evansville",0,1,1,1
"8686","Notre Dame","F Dickinson",0,1,1,1
"8687","Notre Dame","Florida St",1,1,0.5,2
"8688","Notre Dame","Georgetown",1,0,0,1
"8689","Notre Dame","Georgia Tech",1,3,0.75,4
"8690","Notre Dame","Grambling",0,1,1,1
"8691","Notre Dame","G Washington",0,1,1,1
"8692","Notre Dame","Hartford",0,1,1,1
"8693","Notre Dame","Indiana",0,1,1,1
"8694","Notre Dame","Indiana St",1,0,0,1
"8695","Notre Dame","Iowa",1,0,0,1
"8696","Notre Dame","IPFW",0,1,1,1
"8697","Notre Dame","Kennesaw",0,1,1,1
"8698","Notre Dame","Kentucky",0,1,1,1
"8699","Notre Dame","Louisville",1,2,0.666666666666667,3
"8700","Notre Dame","Marquette",1,0,0,1
"8701","Notre Dame","Maryland",1,0,0,1
"8702","Notre Dame","Massachusetts",0,1,1,1
"8703","Notre Dame","Miami FL",1,2,0.666666666666667,3
"8704","Notre Dame","Miami OH",0,1,1,1
"8705","Notre Dame","Michigan St",0,1,1,1
"8706","Notre Dame","Monmouth NJ",0,1,1,1
"8707","Notre Dame","Mt St Mary's",0,1,1,1
"8708","Notre Dame","Navy",0,1,1,1
"8709","Notre Dame","NC State",1,1,0.5,2
"8710","Notre Dame","N Dakota St",1,0,0,1
"8711","Notre Dame","Niagara",0,1,1,1
"8712","Notre Dame","N Illinois",0,1,1,1
"8713","Notre Dame","North Carolina",2,2,0.5,4
"8714","Notre Dame","Ohio St",1,0,0,1
"8715","Notre Dame","Pittsburgh",2,1,0.333333333333333,3
"8716","Notre Dame","Providence",2,0,0,2
"8717","Notre Dame","Purdue",0,2,1,2
"8718","Notre Dame","Rutgers",0,1,1,1
"8719","Notre Dame","Santa Clara",0,1,1,1
"8720","Notre Dame","Seton Hall",0,1,1,1
"8721","Notre Dame","South Florida",0,1,1,1
"8722","Notre Dame","Stetson",0,1,1,1
"8723","Notre Dame","St Francis PA",0,1,1,1
"8724","Notre Dame","St John's",1,1,0.5,2
"8725","Notre Dame","St Joseph's PA",1,0,0,1
"8726","Notre Dame","Syracuse",3,0,0,3
"8727","Notre Dame","Villanova",0,1,1,1
"8728","Notre Dame","Virginia",3,0,0,3
"8729","Notre Dame","Virginia Tech",0,2,1,2
"8730","Notre Dame","Wake Forest",2,1,0.333333333333333,3
"8731","Oakland","Alabama",1,0,0,1
"8732","Oakland","Arizona",1,0,0,1
"8733","Oakland","Boise St",1,0,0,1
"8734","Oakland","California",1,0,0,1
"8735","Oakland","Chicago St",0,1,1,1
"8736","Oakland","Clemson",1,0,0,1
"8737","Oakland","Cleveland St",3,1,0.25,4
"8738","Oakland","Detroit",1,3,0.75,4
"8739","Oakland","E Michigan",2,1,0.333333333333333,3
"8740","Oakland","Georgia St",1,0,0,1
"8741","Oakland","Gonzaga",1,0,0,1
"8742","Oakland","IL Chicago",1,4,0.8,5
"8743","Oakland","Illinois St",0,1,1,1
"8744","Oakland","Indiana",1,0,0,1
"8745","Oakland","Iowa St",1,0,0,1
"8746","Oakland","IPFW",2,0,0,2
"8747","Oakland","IUPUI",0,2,1,2
"8748","Oakland","Maryland",1,0,0,1
"8749","Oakland","Michigan St",3,0,0,3
"8750","Oakland","Missouri KC",0,2,1,2
"8751","Oakland","Morehead St",0,2,1,2
"8752","Oakland","N Dakota St",1,1,0.5,2
"8753","Oakland","NE Omaha",0,2,1,2
"8754","Oakland","North Carolina",1,0,0,1
"8755","Oakland","Ohio",1,1,0.5,2
"8756","Oakland","Pittsburgh",2,0,0,2
"8757","Oakland","Robert Morris",0,1,1,1
"8758","Oakland","S Dakota St",1,1,0.5,2
"8759","Oakland","South Dakota",1,1,0.5,2
"8760","Oakland","St Francis NY",1,0,0,1
"8761","Oakland","Tennessee",1,0,0,1
"8762","Oakland","Toledo",0,1,1,1
"8763","Oakland","TX Southern",0,1,1,1
"8764","Oakland","UCLA",1,0,0,1
"8765","Oakland","ULL",2,0,0,2
"8766","Oakland","Valparaiso",2,3,0.6,5
"8767","Oakland","W Carolina",1,0,0,1
"8768","Oakland","West Virginia",1,0,0,1
"8769","Oakland","WI Green Bay",3,1,0.25,4
"8770","Oakland","W Illinois",1,1,0.5,2
"8771","Oakland","WI Milwaukee",3,1,0.25,4
"8772","Oakland","W Michigan",3,0,0,3
"8773","Oakland","Wright St",3,2,0.4,5
"8774","Oakland","Youngstown St",0,5,1,5
"8775","Oakland","Albion",0,1,1,1
"8776","Oakland","Defiance",0,1,1,1
"8777","Oakland","Rochester MI",0,2,1,2
"8778","Ohio","Akron",5,2,0.285714285714286,7
"8779","Ohio","Alabama A&M",0,1,1,1
"8780","Ohio","Alcorn St",0,1,1,1
"8781","Ohio","Appalachian St",0,1,1,1
"8782","Ohio","Ark Pine Bluff",0,1,1,1
"8783","Ohio","Ball St",0,4,1,4
"8784","Ohio","Belmont",2,0,0,2
"8785","Ohio","Bowling Green",3,3,0.5,6
"8786","Ohio","Buffalo",2,4,0.666666666666667,6
"8787","Ohio","C Michigan",2,2,0.5,4
"8788","Ohio","DePaul",0,1,1,1
"8789","Ohio","E Michigan",1,3,0.75,4
"8790","Ohio","Evansville",1,1,0.5,2
"8791","Ohio","FL Gulf Coast",1,0,0,1
"8792","Ohio","G Washington",1,0,0,1
"8793","Ohio","Hampton",0,1,1,1
"8794","Ohio","Kent",3,3,0.5,6
"8795","Ohio","Longwood",0,1,1,1
"8796","Ohio","Marshall",0,1,1,1
"8797","Ohio","Massachusetts",2,0,0,2
"8798","Ohio","MD E Shore",0,1,1,1
"8799","Ohio","Memphis",1,0,0,1
"8800","Ohio","Mercer",0,1,1,1
"8801","Ohio","Miami OH",1,6,0.857142857142857,7
"8802","Ohio","Morgan St",0,1,1,1
"8803","Ohio","Nebraska",1,0,0,1
"8804","Ohio","N Illinois",1,2,0.666666666666667,3
"8805","Ohio","Northern Iowa",0,1,1,1
"8806","Ohio","Oakland",1,1,0.5,2
"8807","Ohio","Ohio St",1,0,0,1
"8808","Ohio","Oklahoma",1,0,0,1
"8809","Ohio","Portland",0,1,1,1
"8810","Ohio","Richmond",0,2,1,2
"8811","Ohio","Robert Morris",1,0,0,1
"8812","Ohio","St Bonaventure",1,1,0.5,2
"8813","Ohio","Toledo",2,2,0.5,4
"8814","Ohio","UNC Asheville",0,1,1,1
"8815","Ohio","UNC Wilmington",0,2,1,2
"8816","Ohio","Valparaiso",0,1,1,1
"8817","Ohio","Winthrop",1,0,0,1
"8818","Ohio","W Michigan",4,1,0.2,5
"8819","Ohio","Wofford",0,1,1,1
"8820","Ohio","Heidelberg",0,1,1,1
"8821","Ohio St","Albany NY",0,1,1,1
"8822","Ohio St","American Univ",0,1,1,1
"8823","Ohio St","Bryant",0,1,1,1
"8824","Ohio St","Campbell",0,1,1,1
"8825","Ohio St","Central Conn",0,1,1,1
"8826","Ohio St","Chicago St",0,1,1,1
"8827","Ohio St","Colgate",0,1,1,1
"8828","Ohio St","Delaware",0,1,1,1
"8829","Ohio St","Duke",1,0,0,1
"8830","Ohio St","High Point",0,1,1,1
"8831","Ohio St","Illinois",1,4,0.8,5
"8832","Ohio St","Indiana",3,2,0.4,5
"8833","Ohio St","Iowa",3,2,0.4,5
"8834","Ohio St","James Madison",0,1,1,1
"8835","Ohio St","Kansas",1,0,0,1
"8836","Ohio St","Long Beach St",0,1,1,1
"8837","Ohio St","Louisville",1,0,0,1
"8838","Ohio St","Marquette",0,2,1,2
"8839","Ohio St","Maryland",0,2,1,2
"8840","Ohio St","Miami OH",0,1,1,1
"8841","Ohio St","Michigan",4,2,0.333333333333333,6
"8842","Ohio St","Michigan St",4,2,0.333333333333333,6
"8843","Ohio St","Minnesota",1,4,0.8,5
"8844","Ohio St","Missouri KC",0,1,1,1
"8845","Ohio St","Morehead St",0,1,1,1
"8846","Ohio St","Morgan St",0,1,1,1
"8847","Ohio St","NC A&T",0,1,1,1
"8848","Ohio St","N Dakota St",0,1,1,1
"8849","Ohio St","Nebraska",1,5,0.833333333333333,6
"8850","Ohio St","N Kentucky",0,1,1,1
"8851","Ohio St","North Carolina",1,0,0,1
"8852","Ohio St","North Florida",0,1,1,1
"8853","Ohio St","Northwestern",0,4,1,4
"8854","Ohio St","Notre Dame",0,1,1,1
"8855","Ohio St","Ohio",0,1,1,1
"8856","Ohio St","Penn St",2,3,0.6,5
"8857","Ohio St","Purdue",1,5,0.833333333333333,6
"8858","Ohio St","Rhode Island",0,1,1,1
"8859","Ohio St","Rutgers",0,1,1,1
"8860","Ohio St","Sacred Heart",0,1,1,1
"8861","Ohio St","Savannah St",0,1,1,1
"8862","Ohio St","ULM",0,1,1,1
"8863","Ohio St","UNC Asheville",0,1,1,1
"8864","Ohio St","Washington",0,1,1,1
"8865","Ohio St","Winthrop",0,1,1,1
"8866","Ohio St","Wisconsin",2,2,0.5,4
"8867","Ohio St","Wright St",0,1,1,1
"8868","Ohio St","Wyoming",0,1,1,1
"8869","Ohio St","MA Lowell",0,1,1,1
"8870","Oklahoma","Alabama",0,1,1,1
"8871","Oklahoma","Arkansas",1,0,0,1
"8872","Oklahoma","Ark Little Rock",0,1,1,1
"8873","Oklahoma","Baylor",2,5,0.714285714285714,7
"8874","Oklahoma","Butler",0,1,1,1
"8875","Oklahoma","Creighton",1,0,0,1
"8876","Oklahoma","George Mason",0,2,1,2
"8877","Oklahoma","Gonzaga",1,0,0,1
"8878","Oklahoma","Idaho",0,1,1,1
"8879","Oklahoma","Iowa St",4,3,0.428571428571429,7
"8880","Oklahoma","Kansas",4,2,0.333333333333333,6
"8881","Oklahoma","Kansas St",5,1,0.166666666666667,6
"8882","Oklahoma","Louisiana Tech",1,0,0,1
"8883","Oklahoma","Mercer",0,1,1,1
"8884","Oklahoma","Michigan St",1,0,0,1
"8885","Oklahoma","Missouri",0,1,1,1
"8886","Oklahoma","North Texas",0,1,1,1
"8887","Oklahoma","Northwestern LA",0,2,1,2
"8888","Oklahoma","Ohio",0,1,1,1
"8889","Oklahoma","Oklahoma St",1,6,0.857142857142857,7
"8890","Oklahoma","Oral Roberts",0,2,1,2
"8891","Oklahoma","SE Louisiana",0,1,1,1
"8892","Oklahoma","Seton Hall",0,1,1,1
"8893","Oklahoma","SF Austin",1,0,0,1
"8894","Oklahoma","TAM C. Christi",0,2,1,2
"8895","Oklahoma","TCU",1,5,0.833333333333333,6
"8896","Oklahoma","Texas",1,5,0.833333333333333,6
"8897","Oklahoma","Texas A&M",0,2,1,2
"8898","Oklahoma","Texas Tech",1,5,0.833333333333333,6
"8899","Oklahoma","Tulsa",0,2,1,2
"8900","Oklahoma","UCLA",0,1,1,1
"8901","Oklahoma","ULM",0,1,1,1
"8902","Oklahoma","UT Arlington",0,2,1,2
"8903","Oklahoma","UTEP",0,1,1,1
"8904","Oklahoma","Washington",1,0,0,1
"8905","Oklahoma","Weber St",0,1,1,1
"8906","Oklahoma","West Virginia",2,5,0.714285714285714,7
"8907","Oklahoma","Wisconsin",1,0,0,1
"8908","Oklahoma St","Akron",0,1,1,1
"8909","Oklahoma St","Ark Pine Bluff",0,1,1,1
"8910","Oklahoma St","Baylor",3,3,0.5,6
"8911","Oklahoma St","Butler",0,1,1,1
"8912","Oklahoma St","Cent Arkansas",0,1,1,1
"8913","Oklahoma St","Colorado",0,1,1,1
"8914","Oklahoma St","Delaware St",0,1,1,1
"8915","Oklahoma St","Gonzaga",1,0,0,1
"8916","Oklahoma St","Iowa St",5,1,0.166666666666667,6
"8917","Oklahoma St","Kansas",4,3,0.428571428571429,7
"8918","Oklahoma St","Kansas St",3,3,0.5,6
"8919","Oklahoma St","Louisiana Tech",0,1,1,1
"8920","Oklahoma St","Maryland",1,0,0,1
"8921","Oklahoma St","Memphis",1,2,0.666666666666667,3
"8922","Oklahoma St","Missouri",0,1,1,1
"8923","Oklahoma St","Missouri St",0,1,1,1
"8924","Oklahoma St","MS Valley St",0,1,1,1
"8925","Oklahoma St","NC State",0,1,1,1
"8926","Oklahoma St","North Texas",0,1,1,1
"8927","Oklahoma St","Oklahoma",6,1,0.142857142857143,7
"8928","Oklahoma St","Oregon St",0,1,1,1
"8929","Oklahoma St","Portland St",0,1,1,1
"8930","Oklahoma St","Prairie View",0,1,1,1
"8931","Oklahoma St","Purdue",0,1,1,1
"8932","Oklahoma St","Robert Morris",0,1,1,1
"8933","Oklahoma St","SE Louisiana",0,1,1,1
"8934","Oklahoma St","South Carolina",1,1,0.5,2
"8935","Oklahoma St","South Florida",0,2,1,2
"8936","Oklahoma St","TCU",1,5,0.833333333333333,6
"8937","Oklahoma St","Tennessee",0,1,1,1
"8938","Oklahoma St","Tennessee Tech",0,1,1,1
"8939","Oklahoma St","Texas",1,5,0.833333333333333,6
"8940","Oklahoma St","Texas Tech",2,5,0.714285714285714,7
"8941","Oklahoma St","Tulsa",0,1,1,1
"8942","Oklahoma St","UC Davis",0,1,1,1
"8943","Oklahoma St","Utah Valley",0,1,1,1
"8944","Oklahoma St","UT Arlington",0,1,1,1
"8945","Oklahoma St","Virginia Tech",1,0,0,1
"8946","Oklahoma St","West Virginia",2,4,0.666666666666667,6
"8947","Oklahoma St","WI Milwaukee",0,1,1,1
"8948","Oklahoma St","MTSU",0,1,1,1
"8949","Oklahoma St","NW Oklahoma St",0,1,1,1
"8950","Old Dominion","Charlotte",1,2,0.666666666666667,3
"8951","Old Dominion","Cleveland St",1,0,0,1
"8952","Old Dominion","Col Charleston",2,0,0,2
"8953","Old Dominion","Delaware",2,0,0,2
"8954","Old Dominion","Drexel",1,1,0.5,2
"8955","Old Dominion","East Carolina",0,2,1,2
"8956","Old Dominion","Fairfield",1,0,0,1
"8957","Old Dominion","FL Atlantic",0,2,1,2
"8958","Old Dominion","Florida Intl",0,2,1,2
"8959","Old Dominion","Gardner Webb",0,1,1,1
"8960","Old Dominion","Ga Southern",0,1,1,1
"8961","Old Dominion","George Mason",2,2,0.5,4
"8962","Old Dominion","Georgia St",3,1,0.25,4
"8963","Old Dominion","Hofstra",1,0,0,1
"8964","Old Dominion","Holy Cross",1,0,0,1
"8965","Old Dominion","Howard",0,1,1,1
"8966","Old Dominion","Illinois St",1,0,0,1
"8967","Old Dominion","James Madison",2,0,0,2
"8968","Old Dominion","Louisiana Tech",1,1,0.5,2
"8969","Old Dominion","LSU",0,1,1,1
"8970","Old Dominion","Marshall",0,4,1,4
"8971","Old Dominion","MD E Shore",0,1,1,1
"8972","Old Dominion","Middle Tenn St",2,0,0,2
"8973","Old Dominion","Missouri St",1,0,0,1
"8974","Old Dominion","Morgan St",0,1,1,1
"8975","Old Dominion","Mt St Mary's",0,1,1,1
"8976","Old Dominion","Murray St",1,1,0.5,2
"8977","Old Dominion","NC A&T",0,1,1,1
"8978","Old Dominion","NC Central",1,0,0,1
"8979","Old Dominion","Northeastern",1,1,0.5,2
"8980","Old Dominion","North Texas",0,3,1,3
"8981","Old Dominion","Presbyterian",0,1,1,1
"8982","Old Dominion","Rice",0,3,1,3
"8983","Old Dominion","Richmond",2,1,0.333333333333333,3
"8984","Old Dominion","Southern Miss",1,1,0.5,2
"8985","Old Dominion","St Louis",1,0,0,1
"8986","Old Dominion","Towson",1,0,0,1
"8987","Old Dominion","Tulane",0,1,1,1
"8988","Old Dominion","Tulsa",1,0,0,1
"8989","Old Dominion","UAB",2,0,0,2
"8990","Old Dominion","UCF",1,0,0,1
"8991","Old Dominion","UNC Wilmington",1,3,0.75,4
"8992","Old Dominion","UTEP",2,0,0,2
"8993","Old Dominion","UT San Antonio",2,1,0.333333333333333,3
"8994","Old Dominion","VA Commonwealth",2,1,0.333333333333333,3
"8995","Old Dominion","Virginia",0,1,1,1
"8996","Old Dominion","VMI",1,0,0,1
"8997","Old Dominion","West Virginia",1,0,0,1
"8998","Old Dominion","William & Mary",3,1,0.25,4
"8999","Old Dominion","W Kentucky",1,1,0.5,2
"9000","Old Dominion","MTSU",2,0,0,2
"9001","Oral Roberts","Akron",1,0,0,1
"9002","Oral Roberts","Arizona",1,0,0,1
"9003","Oral Roberts","Baylor",1,0,0,1
"9004","Oral Roberts","Belmont",1,0,0,1
"9005","Oral Roberts","Bowling Green",0,1,1,1
"9006","Oral Roberts","Cent Arkansas",1,3,0.75,4
"9007","Oral Roberts","Charlotte",1,0,0,1
"9008","Oral Roberts","Denver",1,1,0.5,2
"9009","Oral Roberts","Detroit",0,1,1,1
"9010","Oral Roberts","Ga Southern",0,1,1,1
"9011","Oral Roberts","Houston Bap",0,2,1,2
"9012","Oral Roberts","IPFW",1,1,0.5,2
"9013","Oral Roberts","IUPUI",0,3,1,3
"9014","Oral Roberts","Kansas St",1,0,0,1
"9015","Oral Roberts","Lamar",0,3,1,3
"9016","Oral Roberts","Loy Marymount",0,1,1,1
"9017","Oral Roberts","McNeese St",2,2,0.5,4
"9018","Oral Roberts","Memphis",2,0,0,2
"9019","Oral Roberts","Missouri",1,0,0,1
"9020","Oral Roberts","Missouri St",2,2,0.5,4
"9021","Oral Roberts","N Dakota St",2,1,0.333333333333333,3
"9022","Oral Roberts","NE Omaha",0,2,1,2
"9023","Oral Roberts","New Mexico St",0,1,1,1
"9024","Oral Roberts","New Orleans",0,1,1,1
"9025","Oral Roberts","Nicholls St",1,2,0.666666666666667,3
"9026","Oral Roberts","Northwestern LA",3,1,0.25,4
"9027","Oral Roberts","Oklahoma",2,0,0,2
"9028","Oral Roberts","Oregon St",1,0,0,1
"9029","Oral Roberts","Pacific",0,1,1,1
"9030","Oral Roberts","Sam Houston St",1,3,0.75,4
"9031","Oral Roberts","S Dakota St",2,0,0,2
"9032","Oral Roberts","SE Louisiana",0,3,1,3
"9033","Oral Roberts","SF Austin",4,0,0,4
"9034","Oral Roberts","South Dakota",1,1,0.5,2
"9035","Oral Roberts","St Louis",1,0,0,1
"9036","Oral Roberts","TAM C. Christi",2,2,0.5,4
"9037","Oral Roberts","Texas St",0,2,1,2
"9038","Oral Roberts","Tulsa",1,2,0.666666666666667,3
"9039","Oral Roberts","ULL",1,0,0,1
"9040","Oral Roberts","UTEP",1,0,0,1
"9041","Oral Roberts","Weber St",2,0,0,2
"9042","Oral Roberts","Wichita St",1,0,0,1
"9043","Oral Roberts","W Illinois",0,2,1,2
"9044","Oral Roberts","WI Milwaukee",0,1,1,1
"9045","Oral Roberts","Wisconsin",1,0,0,1
"9046","Oral Roberts","Abilene Chr",0,1,1,1
"9047","Oral Roberts","Cameron",0,1,1,1
"9048","Oral Roberts","Dallas Bap",0,1,1,1
"9049","Oral Roberts","Haskell",0,1,1,1
"9050","Oral Roberts","Incarnate Word",0,1,1,1
"9051","Oral Roberts","Tabor",0,1,1,1
"9052","Oregon","Arizona",4,2,0.333333333333333,6
"9053","Oregon","Arizona St",1,4,0.8,5
"9054","Oregon","Ark Pine Bluff",0,1,1,1
"9055","Oregon","BYU",0,1,1,1
"9056","Oregon","California",3,1,0.25,4
"9057","Oregon","Cal Poly SLO",0,1,1,1
"9058","Oregon","Cincinnati",1,0,0,1
"9059","Oregon","Colorado",3,2,0.4,5
"9060","Oregon","Coppin St",0,1,1,1
"9061","Oregon","CS Northridge",0,1,1,1
"9062","Oregon","Delaware St",0,1,1,1
"9063","Oregon","Detroit",0,1,1,1
"9064","Oregon","Georgetown",0,1,1,1
"9065","Oregon","Houston Bap",0,1,1,1
"9066","Oregon","Idaho St",0,1,1,1
"9067","Oregon","Illinois",0,2,1,2
"9068","Oregon","Jacksonville St",0,1,1,1
"9069","Oregon","Michigan",1,0,0,1
"9070","Oregon","Mississippi",1,1,0.5,2
"9071","Oregon","Morgan St",0,1,1,1
"9072","Oregon","Nebraska",0,1,1,1
"9073","Oregon","Nevada",0,1,1,1
"9074","Oregon","North Dakota",0,1,1,1
"9075","Oregon","Northern Arizona",0,1,1,1
"9076","Oregon","Oregon St",1,6,0.857142857142857,7
"9077","Oregon","Pacific",0,1,1,1
"9078","Oregon","Portland St",0,2,1,2
"9079","Oregon","San Francisco",0,1,1,1
"9080","Oregon","Santa Barbara",0,1,1,1
"9081","Oregon","Stanford",2,2,0.5,4
"9082","Oregon","Toledo",0,1,1,1
"9083","Oregon","UC Irvine",0,2,1,2
"9084","Oregon","UCLA",3,3,0.5,6
"9085","Oregon","UNLV",0,1,1,1
"9086","Oregon","USC",0,5,1,5
"9087","Oregon","Utah",1,4,0.8,5
"9088","Oregon","Utah Valley",0,1,1,1
"9089","Oregon","UTEP",1,0,0,1
"9090","Oregon","UT San Antonio",0,1,1,1
"9091","Oregon","VA Commonwealth",1,0,0,1
"9092","Oregon","Vanderbilt",0,1,1,1
"9093","Oregon","Washington",2,4,0.666666666666667,6
"9094","Oregon","Washington St",1,5,0.833333333333333,6
"9095","Oregon","W Carolina",0,1,1,1
"9096","Oregon","Concordia OR",0,1,1,1
"9097","Oregon St","Akron",1,0,0,1
"9098","Oregon St","Alabama",1,0,0,1
"9099","Oregon St","Arizona",4,1,0.2,5
"9100","Oregon St","Arizona St",3,2,0.4,5
"9101","Oregon St","Ark Pine Bluff",0,1,1,1
"9102","Oregon St","Auburn",1,0,0,1
"9103","Oregon St","California",4,0,0,4
"9104","Oregon St","Chicago St",0,1,1,1
"9105","Oregon St","Colorado",3,2,0.4,5
"9106","Oregon St","Coppin St",1,0,0,1
"9107","Oregon St","DePaul",1,1,0.5,2
"9108","Oregon St","Edwardsville",0,1,1,1
"9109","Oregon St","George Mason",0,1,1,1
"9110","Oregon St","Grambling",0,2,1,2
"9111","Oregon St","Hawaii",1,0,0,1
"9112","Oregon St","Howard",0,1,1,1
"9113","Oregon St","Kansas",1,0,0,1
"9114","Oregon St","Maryland",0,1,1,1
"9115","Oregon St","MD E Shore",0,1,1,1
"9116","Oregon St","Mississippi St",0,1,1,1
"9117","Oregon St","Montana St",0,1,1,1
"9118","Oregon St","MS Valley St",0,1,1,1
"9119","Oregon St","New Mexico St",0,1,1,1
"9120","Oregon St","Niagara",0,1,1,1
"9121","Oregon St","Oklahoma St",1,0,0,1
"9122","Oregon St","Oral Roberts",0,1,1,1
"9123","Oregon St","Oregon",6,1,0.142857142857143,7
"9124","Oregon St","Portland",0,2,1,2
"9125","Oregon St","Portland St",0,1,1,1
"9126","Oregon St","Purdue",0,1,1,1
"9127","Oregon St","Quinnipiac",1,1,0.5,2
"9128","Oregon St","Rice",0,1,1,1
"9129","Oregon St","San Diego",0,1,1,1
"9130","Oregon St","Santa Barbara",0,1,1,1
"9131","Oregon St","Stanford",3,1,0.25,4
"9132","Oregon St","Towson",1,1,0.5,2
"9133","Oregon St","TX Pan American",0,1,1,1
"9134","Oregon St","UCLA",3,2,0.4,5
"9135","Oregon St","USC",2,3,0.6,5
"9136","Oregon St","Utah",3,1,0.25,4
"9137","Oregon St","Washington",4,2,0.333333333333333,6
"9138","Oregon St","Washington St",1,5,0.833333333333333,6
"9139","Oregon St","Corban",0,1,1,1
"9140","Pacific","Bradley",0,1,1,1
"9141","Pacific","BYU",3,1,0.25,4
"9142","Pacific","California",1,0,0,1
"9143","Pacific","Cal Poly SLO",1,2,0.666666666666667,3
"9144","Pacific","Colorado St",1,0,0,1
"9145","Pacific","CS Fullerton",0,2,1,2
"9146","Pacific","CS Northridge",0,2,1,2
"9147","Pacific","Fresno St",1,2,0.666666666666667,3
"9148","Pacific","Gonzaga",5,0,0,5
"9149","Pacific","Hawaii",1,1,0.5,2
"9150","Pacific","Idaho St",0,1,1,1
"9151","Pacific","Long Beach St",1,1,0.5,2
"9152","Pacific","Loy Marymount",2,2,0.5,4
"9153","Pacific","Mercer",0,1,1,1
"9154","Pacific","Nevada",0,3,1,3
"9155","Pacific","North Dakota",0,1,1,1
"9156","Pacific","Oral Roberts",1,0,0,1
"9157","Pacific","Oregon",1,0,0,1
"9158","Pacific","Pepperdine",3,1,0.25,4
"9159","Pacific","Portland",2,2,0.5,4
"9160","Pacific","Princeton",1,0,0,1
"9161","Pacific","San Diego",2,2,0.5,4
"9162","Pacific","San Francisco",5,1,0.166666666666667,6
"9163","Pacific","Santa Barbara",1,1,0.5,2
"9164","Pacific","Santa Clara",4,2,0.333333333333333,6
"9165","Pacific","St Mary's CA",5,1,0.166666666666667,6
"9166","Pacific","UC Davis",0,2,1,2
"9167","Pacific","UC Irvine",2,2,0.5,4
"9168","Pacific","UC Riverside",0,2,1,2
"9169","Pacific","Utah St",0,1,1,1
"9170","Pacific","Washington",1,0,0,1
"9171","Pacific","W Illinois",0,2,1,2
"9172","Pacific","W Michigan",2,0,0,2
"9173","Pacific","Xavier",0,1,1,1
"9174","Pacific","AK Anchorage",0,1,1,1
"9175","Pacific","Menlo",0,1,1,1
"9176","Pacific","CSU East Bay",0,1,1,1
"9177","Pacific","Pacific Union",0,1,1,1
"9178","Penn","Binghamton",0,2,1,2
"9179","Penn","Brown",4,2,0.333333333333333,6
"9180","Penn","Butler",1,0,0,1
"9181","Penn","Columbia",3,3,0.5,6
"9182","Penn","Cornell",1,5,0.833333333333333,6
"9183","Penn","Dartmouth",3,3,0.5,6
"9184","Penn","Delaware",2,0,0,2
"9185","Penn","Delaware St",1,0,0,1
"9186","Penn","Drexel",1,0,0,1
"9187","Penn","Fairfield",1,0,0,1
"9188","Penn","Fordham",1,0,0,1
"9189","Penn","George Mason",1,0,0,1
"9190","Penn","Harvard",5,1,0.166666666666667,6
"9191","Penn","Iowa",1,0,0,1
"9192","Penn","Lafayette",3,0,0,3
"9193","Penn","La Salle",3,0,0,3
"9194","Penn","Lehigh",1,0,0,1
"9195","Penn","Marist",1,1,0.5,2
"9196","Penn","MD Baltimore Co",0,1,1,1
"9197","Penn","Monmouth NJ",1,1,0.5,2
"9198","Penn","Navy",0,1,1,1
"9199","Penn","Niagara",0,2,1,2
"9200","Penn","NJIT",0,2,1,2
"9201","Penn","Penn St",2,0,0,2
"9202","Penn","Princeton",4,1,0.2,5
"9203","Penn","Rider",2,0,0,2
"9204","Penn","St Joseph's PA",2,1,0.333333333333333,3
"9205","Penn","Temple",3,0,0,3
"9206","Penn","Vanderbilt",1,0,0,1
"9207","Penn","Villanova",3,0,0,3
"9208","Penn","Wagner",3,0,0,3
"9209","Penn","Yale",6,0,0,6
"9210","Penn St","Akron",1,1,0.5,2
"9211","Penn St","Army",0,1,1,1
"9212","Penn St","Boston College",1,0,0,1
"9213","Penn St","Bucknell",1,2,0.666666666666667,3
"9214","Penn St","Charlotte",1,0,0,1
"9215","Penn St","Cornell",0,1,1,1
"9216","Penn St","Dartmouth",0,1,1,1
"9217","Penn St","Delaware St",0,1,1,1
"9218","Penn St","Drexel",0,1,1,1
"9219","Penn St","Duquesne",0,3,1,3
"9220","Penn St","Fordham",0,1,1,1
"9221","Penn St","G Washington",0,1,1,1
"9222","Penn St","Illinois",4,0,0,4
"9223","Penn St","Indiana",4,1,0.2,5
"9224","Penn St","Iowa",4,1,0.2,5
"9225","Penn St","La Salle",1,1,0.5,2
"9226","Penn St","Longwood",0,1,1,1
"9227","Penn St","Marshall",0,2,1,2
"9228","Penn St","Maryland",2,0,0,2
"9229","Penn St","Michigan",3,1,0.25,4
"9230","Penn St","Michigan St",4,0,0,4
"9231","Penn St","Minnesota",4,2,0.333333333333333,6
"9232","Penn St","Mississippi",1,0,0,1
"9233","Penn St","Monmouth NJ",0,1,1,1
"9234","Penn St","Morgan St",0,1,1,1
"9235","Penn St","Mt St Mary's",0,1,1,1
"9236","Penn St","NC State",1,0,0,1
"9237","Penn St","Nebraska",3,3,0.5,6
"9238","Penn St","New Hampshire",0,1,1,1
"9239","Penn St","Northwestern",2,2,0.5,4
"9240","Penn St","Ohio St",3,2,0.4,5
"9241","Penn St","Penn",0,2,1,2
"9242","Penn St","Pittsburgh",1,0,0,1
"9243","Penn St","Princeton",1,0,0,1
"9244","Penn St","Providence",0,1,1,1
"9245","Penn St","Purdue",5,1,0.166666666666667,6
"9246","Penn St","Rutgers",1,1,0.5,2
"9247","Penn St","St Francis PA",0,1,1,1
"9248","Penn St","St John's",0,1,1,1
"9249","Penn St","USC",0,1,1,1
"9250","Penn St","Virginia Tech",0,1,1,1
"9251","Penn St","Wagner",0,1,1,1
"9252","Penn St","Wisconsin",5,0,0,5
"9253","Pepperdine","Alabama St",0,1,1,1
"9254","Pepperdine","Arizona St",1,0,0,1
"9255","Pepperdine","BYU",3,3,0.5,6
"9256","Pepperdine","California",1,0,0,1
"9257","Pepperdine","C Michigan",1,1,0.5,2
"9258","Pepperdine","CS Fullerton",1,1,0.5,2
"9259","Pepperdine","CS Northridge",1,1,0.5,2
"9260","Pepperdine","Denver",0,1,1,1
"9261","Pepperdine","Fresno St",0,1,1,1
"9262","Pepperdine","Gonzaga",7,0,0,7
"9263","Pepperdine","Hawaii",0,1,1,1
"9264","Pepperdine","Houston Bap",0,2,1,2
"9265","Pepperdine","Howard",0,1,1,1
"9266","Pepperdine","Indiana St",1,0,0,1
"9267","Pepperdine","Iowa",1,0,0,1
"9268","Pepperdine","IUPUI",1,0,0,1
"9269","Pepperdine","Loy Marymount",0,6,1,6
"9270","Pepperdine","Montana St",0,1,1,1
"9271","Pepperdine","Pacific",1,3,0.75,4
"9272","Pepperdine","Portland",2,4,0.666666666666667,6
"9273","Pepperdine","Richmond",1,0,0,1
"9274","Pepperdine","San Diego",3,4,0.571428571428571,7
"9275","Pepperdine","San Francisco",6,0,0,6
"9276","Pepperdine","San Jose St",1,1,0.5,2
"9277","Pepperdine","Santa Clara",4,2,0.333333333333333,6
"9278","Pepperdine","South Alabama",0,1,1,1
"9279","Pepperdine","St Mary's CA",6,1,0.142857142857143,7
"9280","Pepperdine","Tulane",1,0,0,1
"9281","Pepperdine","UC Irvine",0,2,1,2
"9282","Pepperdine","UC Riverside",0,2,1,2
"9283","Pepperdine","Utah Valley",1,1,0.5,2
"9284","Pepperdine","Washington St",1,1,0.5,2
"9285","Pepperdine","WI Green Bay",1,0,0,1
"9286","Pepperdine","San Diego Chr",0,1,1,1
"9287","Pepperdine","Cal Lutheran",0,1,1,1
"9288","Pittsburgh","Albany NY",0,1,1,1
"9289","Pittsburgh","Bethune-Cookman",0,1,1,1
"9290","Pittsburgh","Boston College",0,3,1,3
"9291","Pittsburgh","Bryant",0,1,1,1
"9292","Pittsburgh","Cal Poly SLO",0,1,1,1
"9293","Pittsburgh","Cincinnati",2,1,0.333333333333333,3
"9294","Pittsburgh","Clemson",1,2,0.666666666666667,3
"9295","Pittsburgh","Connecticut",0,1,1,1
"9296","Pittsburgh","Delaware",0,1,1,1
"9297","Pittsburgh","Delaware St",0,1,1,1
"9298","Pittsburgh","DePaul",0,2,1,2
"9299","Pittsburgh","Detroit",0,1,1,1
"9300","Pittsburgh","Duke",2,0,0,2
"9301","Pittsburgh","Duquesne",0,3,1,3
"9302","Pittsburgh","FL Gulf Coast",0,1,1,1
"9303","Pittsburgh","Florida St",2,1,0.333333333333333,3
"9304","Pittsburgh","Fordham",0,1,1,1
"9305","Pittsburgh","Fresno St",0,1,1,1
"9306","Pittsburgh","Georgetown",0,1,1,1
"9307","Pittsburgh","Georgia Tech",0,2,1,2
"9308","Pittsburgh","Hawaii",1,0,0,1
"9309","Pittsburgh","Holy Cross",0,1,1,1
"9310","Pittsburgh","Howard",0,2,1,2
"9311","Pittsburgh","Indiana",1,0,0,1
"9312","Pittsburgh","Kansas St",0,1,1,1
"9313","Pittsburgh","Kennesaw",0,1,1,1
"9314","Pittsburgh","Lehigh",0,2,1,2
"9315","Pittsburgh","Louisville",3,0,0,3
"9316","Pittsburgh","Loy Marymount",0,1,1,1
"9317","Pittsburgh","Manhattan",0,1,1,1
"9318","Pittsburgh","Marquette",2,0,0,2
"9319","Pittsburgh","Maryland",0,2,1,2
"9320","Pittsburgh","Miami FL",1,1,0.5,2
"9321","Pittsburgh","Michigan",1,0,0,1
"9322","Pittsburgh","Mt St Mary's",0,1,1,1
"9323","Pittsburgh","NC State",3,1,0.25,4
"9324","Pittsburgh","Niagara",0,1,1,1
"9325","Pittsburgh","North Carolina",1,2,0.666666666666667,3
"9326","Pittsburgh","North Florida",0,1,1,1
"9327","Pittsburgh","Notre Dame",1,2,0.666666666666667,3
"9328","Pittsburgh","Oakland",0,2,1,2
"9329","Pittsburgh","Penn St",0,1,1,1
"9330","Pittsburgh","Providence",0,1,1,1
"9331","Pittsburgh","Rutgers",1,0,0,1
"9332","Pittsburgh","Samford",0,1,1,1
"9333","Pittsburgh","San Diego St",1,0,0,1
"9334","Pittsburgh","Savannah St",0,1,1,1
"9335","Pittsburgh","Seton Hall",0,1,1,1
"9336","Pittsburgh","South Florida",0,1,1,1
"9337","Pittsburgh","Stanford",0,1,1,1
"9338","Pittsburgh","St Bonaventure",0,1,1,1
"9339","Pittsburgh","St John's",0,1,1,1
"9340","Pittsburgh","Syracuse",2,3,0.6,5
"9341","Pittsburgh","Texas Tech",0,1,1,1
"9342","Pittsburgh","Villanova",0,2,1,2
"9343","Pittsburgh","Virginia",3,0,0,3
"9344","Pittsburgh","Virginia Tech",1,1,0.5,2
"9345","Pittsburgh","Wake Forest",1,2,0.666666666666667,3
"9346","Pittsburgh","Youngstown St",0,1,1,1
"9347","Pittsburgh","Chaminade",0,1,1,1
"9348","Portland","Bradley",0,2,1,2
"9349","Portland","BYU",6,1,0.142857142857143,7
"9350","Portland","Colorado St",1,0,0,1
"9351","Portland","Columbia",0,1,1,1
"9352","Portland","CS Bakersfield",0,1,1,1
"9353","Portland","CS Sacramento",0,1,1,1
"9354","Portland","Drake",0,1,1,1
"9355","Portland","Edwardsville",0,1,1,1
"9356","Portland","Gonzaga",5,1,0.166666666666667,6
"9357","Portland","Idaho",0,1,1,1
"9358","Portland","Idaho St",0,1,1,1
"9359","Portland","Kentucky",1,0,0,1
"9360","Portland","Loy Marymount",2,5,0.714285714285714,7
"9361","Portland","Michigan St",1,0,0,1
"9362","Portland","Montana St",2,1,0.333333333333333,3
"9363","Portland","Murray St",0,1,1,1
"9364","Portland","New Mexico",1,0,0,1
"9365","Portland","North Florida",0,1,1,1
"9366","Portland","North Texas",1,0,0,1
"9367","Portland","Ohio",1,0,0,1
"9368","Portland","Oregon St",2,0,0,2
"9369","Portland","Pacific",2,2,0.5,4
"9370","Portland","Pepperdine",4,2,0.333333333333333,6
"9371","Portland","Portland St",0,3,1,3
"9372","Portland","Princeton",0,1,1,1
"9373","Portland","San Diego",4,2,0.333333333333333,6
"9374","Portland","San Francisco",4,2,0.333333333333333,6
"9375","Portland","San Jose St",0,2,1,2
"9376","Portland","Santa Clara",3,3,0.5,6
"9377","Portland","Southern Utah",0,1,1,1
"9378","Portland","St Mary's CA",6,1,0.142857142857143,7
"9379","Portland","TX Pan American",1,0,0,1
"9380","Portland","UC Davis",0,1,1,1
"9381","Portland","UNLV",2,0,0,2
"9382","Portland","Valparaiso",1,0,0,1
"9383","Portland","Washington St",1,0,0,1
"9384","Portland","Concordia OR",0,1,1,1
"9385","Portland","Lewis & Clark",0,1,1,1
"9386","Portland St","Boise St",1,0,0,1
"9387","Portland St","CS Bakersfield",0,1,1,1
"9388","Portland St","CS Northridge",0,1,1,1
"9389","Portland St","CS Sacramento",5,2,0.285714285714286,7
"9390","Portland St","Edwardsville",0,2,1,2
"9391","Portland St","E Washington",2,4,0.666666666666667,6
"9392","Portland St","Idaho",2,1,0.333333333333333,3
"9393","Portland St","Idaho St",3,2,0.4,5
"9394","Portland St","Loy Marymount",1,0,0,1
"9395","Portland St","Loyola-Chicago",0,1,1,1
"9396","Portland St","Montana",4,2,0.333333333333333,6
"9397","Portland St","Montana St",4,1,0.2,5
"9398","Portland St","N Colorado",3,3,0.5,6
"9399","Portland St","North Dakota",4,3,0.428571428571429,7
"9400","Portland St","Northern Arizona",5,1,0.166666666666667,6
"9401","Portland St","Oklahoma St",1,0,0,1
"9402","Portland St","Oregon",2,0,0,2
"9403","Portland St","Oregon St",1,0,0,1
"9404","Portland St","Portland",3,0,0,3
"9405","Portland St","San Francisco",1,0,0,1
"9406","Portland St","Southern Utah",1,5,0.833333333333333,6
"9407","Portland St","UC Davis",0,1,1,1
"9408","Portland St","UC Riverside",1,1,0.5,2
"9409","Portland St","UNLV",1,0,0,1
"9410","Portland St","USC",0,1,1,1
"9411","Portland St","Weber St",3,2,0.4,5
"9412","Portland St","Evergreen St",0,1,1,1
"9413","Portland St","Pac Lutheran",0,1,1,1
"9414","Portland St","Walla Walla",0,1,1,1
"9415","Portland St","Willamette",0,1,1,1
"9416","Prairie View","Alabama A&M",2,5,0.714285714285714,7
"9417","Prairie View","Alabama St",3,3,0.5,6
"9418","Prairie View","Alcorn St",4,2,0.333333333333333,6
"9419","Prairie View","Ark Pine Bluff",4,2,0.333333333333333,6
"9420","Prairie View","Baylor",1,0,0,1
"9421","Prairie View","Bethune-Cookman",0,1,1,1
"9422","Prairie View","Brown",1,0,0,1
"9423","Prairie View","BYU",1,0,0,1
"9424","Prairie View","California",1,0,0,1
"9425","Prairie View","Colorado St",1,0,0,1
"9426","Prairie View","F Dickinson",1,0,0,1
"9427","Prairie View","Grambling",1,5,0.833333333333333,6
"9428","Prairie View","Hawaii",1,0,0,1
"9429","Prairie View","Houston",1,1,0.5,2
"9430","Prairie View","Jackson St",1,6,0.857142857142857,7
"9431","Prairie View","Memphis",1,0,0,1
"9432","Prairie View","Mississippi St",1,0,0,1
"9433","Prairie View","MS Valley St",3,4,0.571428571428571,7
"9434","Prairie View","Navy",0,1,1,1
"9435","Prairie View","N Colorado",1,0,0,1
"9436","Prairie View","New Mexico St",1,0,0,1
"9437","Prairie View","North Texas",0,1,1,1
"9438","Prairie View","Oklahoma St",1,0,0,1
"9439","Prairie View","Rice",1,0,0,1
"9440","Prairie View","Sam Houston St",2,0,0,2
"9441","Prairie View","SF Austin",1,0,0,1
"9442","Prairie View","Southern Univ",6,1,0.142857142857143,7
"9443","Prairie View","TCU",2,0,0,2
"9444","Prairie View","Texas A&M",2,0,0,2
"9445","Prairie View","Texas St",1,0,0,1
"9446","Prairie View","Texas Tech",2,0,0,2
"9447","Prairie View","TX Southern",6,2,0.25,8
"9448","Prairie View","UAB",1,0,0,1
"9449","Prairie View","UCLA",2,0,0,2
"9450","Prairie View","Wisconsin",1,0,0,1
"9451","Prairie View","W Michigan",1,0,0,1
"9452","Prairie View","Schreiner",0,2,1,2
"9453","Presbyterian","American Univ",1,0,0,1
"9454","Presbyterian","Appalachian St",1,1,0.5,2
"9455","Presbyterian","Bowling Green",1,0,0,1
"9456","Presbyterian","Campbell",3,1,0.25,4
"9457","Presbyterian","Charleston So",6,0,0,6
"9458","Presbyterian","Citadel",1,1,0.5,2
"9459","Presbyterian","Clemson",1,0,0,1
"9460","Presbyterian","Coastal Car",5,1,0.166666666666667,6
"9461","Presbyterian","Cornell",1,0,0,1
"9462","Presbyterian","Creighton",1,0,0,1
"9463","Presbyterian","Duke",1,0,0,1
"9464","Presbyterian","Florida A&M",1,0,0,1
"9465","Presbyterian","Furman",2,0,0,2
"9466","Presbyterian","Gardner Webb",4,1,0.2,5
"9467","Presbyterian","Ga Southern",1,0,0,1
"9468","Presbyterian","Georgia Tech",2,0,0,2
"9469","Presbyterian","High Point",4,0,0,4
"9470","Presbyterian","Jacksonville St",1,0,0,1
"9471","Presbyterian","Liberty",1,3,0.75,4
"9472","Presbyterian","Longwood",2,3,0.6,5
"9473","Presbyterian","Louisiana Tech",1,0,0,1
"9474","Presbyterian","Marshall",1,0,0,1
"9475","Presbyterian","Morehead St",1,0,0,1
"9476","Presbyterian","Old Dominion",1,0,0,1
"9477","Presbyterian","Radford",5,0,0,5
"9478","Presbyterian","Samford",2,0,0,2
"9479","Presbyterian","South Carolina",1,0,0,1
"9480","Presbyterian","Tennessee",1,0,0,1
"9481","Presbyterian","TN Martin",2,0,0,2
"9482","Presbyterian","UNC Asheville",3,2,0.4,5
"9483","Presbyterian","UNC Greensboro",1,1,0.5,2
"9484","Presbyterian","Virginia Tech",1,0,0,1
"9485","Presbyterian","VMI",2,0,0,2
"9486","Presbyterian","Wake Forest",1,0,0,1
"9487","Presbyterian","West Virginia",1,0,0,1
"9488","Presbyterian","Winthrop",5,1,0.166666666666667,6
"9489","Presbyterian","Wisconsin",1,0,0,1
"9490","Presbyterian","Wofford",1,0,0,1
"9491","Presbyterian","Montreat And",0,2,1,2
"9492","Presbyterian","Toccoa Falls",0,2,1,2
"9493","Presbyterian","Bob Jones",0,1,1,1
"9494","Presbyterian","Piedmont",0,1,1,1
"9495","Princeton","Akron",1,0,0,1
"9496","Princeton","Brown",1,5,0.833333333333333,6
"9497","Princeton","Bucknell",0,2,1,2
"9498","Princeton","Buffalo",0,1,1,1
"9499","Princeton","Butler",1,0,0,1
"9500","Princeton","California",1,0,0,1
"9501","Princeton","Columbia",1,5,0.833333333333333,6
"9502","Princeton","Cornell",1,5,0.833333333333333,6
"9503","Princeton","Dartmouth",1,5,0.833333333333333,6
"9504","Princeton","Drexel",1,0,0,1
"9505","Princeton","Elon",0,1,1,1
"9506","Princeton","F Dickinson",1,1,0.5,2
"9507","Princeton","Florida A&M",0,1,1,1
"9508","Princeton","Fordham",1,0,0,1
"9509","Princeton","George Mason",1,1,0.5,2
"9510","Princeton","Harvard",5,1,0.166666666666667,6
"9511","Princeton","Kent",0,2,1,2
"9512","Princeton","Lafayette",1,2,0.666666666666667,3
"9513","Princeton","Liberty",0,2,1,2
"9514","Princeton","Lipscomb",0,1,1,1
"9515","Princeton","Norfolk St",0,1,1,1
"9516","Princeton","Northeastern",1,0,0,1
"9517","Princeton","Pacific",0,1,1,1
"9518","Princeton","Penn",1,4,0.8,5
"9519","Princeton","Penn St",0,1,1,1
"9520","Princeton","Portland",1,0,0,1
"9521","Princeton","Rice",0,1,1,1
"9522","Princeton","Rider",0,2,1,2
"9523","Princeton","Rutgers",1,1,0.5,2
"9524","Princeton","San Diego",1,0,0,1
"9525","Princeton","San Jose St",0,1,1,1
"9526","Princeton","Stony Brook",0,1,1,1
"9527","Princeton","St Peter's",1,0,0,1
"9528","Princeton","Syracuse",1,0,0,1
"9529","Princeton","UTEP",1,0,0,1
"9530","Princeton","Wagner",1,0,0,1
"9531","Princeton","Wake Forest",1,0,0,1
"9532","Princeton","Yale",5,1,0.166666666666667,6
"9533","Princeton","Incarnate Word",1,0,0,1
"9534","Princeton","Kean",0,1,1,1
"9535","Princeton","Rowan",0,1,1,1
"9536","Providence","Albany NY",0,1,1,1
"9537","Providence","Binghamton",0,1,1,1
"9538","Providence","Boston College",2,1,0.333333333333333,3
"9539","Providence","Brown",2,1,0.333333333333333,3
"9540","Providence","Bryant",0,1,1,1
"9541","Providence","Butler",1,3,0.75,4
"9542","Providence","Cincinnati",0,1,1,1
"9543","Providence","Colgate",0,1,1,1
"9544","Providence","Connecticut",2,0,0,2
"9545","Providence","Creighton",1,4,0.8,5
"9546","Providence","DePaul",1,4,0.8,5
"9547","Providence","Fairfield",0,2,1,2
"9548","Providence","Florida St",0,1,1,1
"9549","Providence","Georgetown",2,3,0.6,5
"9550","Providence","Holy Cross",0,1,1,1
"9551","Providence","Kentucky",2,0,0,2
"9552","Providence","La Salle",0,1,1,1
"9553","Providence","Louisville",1,0,0,1
"9554","Providence","Maine",0,1,1,1
"9555","Providence","Marist",0,1,1,1
"9556","Providence","Marquette",3,2,0.4,5
"9557","Providence","Maryland",1,0,0,1
"9558","Providence","Massachusetts",2,1,0.333333333333333,3
"9559","Providence","Miami FL",0,1,1,1
"9560","Providence","Mississippi St",0,1,1,1
"9561","Providence","Navy",0,1,1,1
"9562","Providence","NJIT",0,1,1,1
"9563","Providence","Notre Dame",0,2,1,2
"9564","Providence","Penn St",1,0,0,1
"9565","Providence","Pittsburgh",1,0,0,1
"9566","Providence","Rhode Island",0,3,1,3
"9567","Providence","Rutgers",0,1,1,1
"9568","Providence","Seton Hall",1,6,0.857142857142857,7
"9569","Providence","South Florida",0,1,1,1
"9570","Providence","St John's",3,4,0.571428571428571,7
"9571","Providence","Stony Brook",0,1,1,1
"9572","Providence","Syracuse",2,0,0,2
"9573","Providence","UNC Asheville",0,1,1,1
"9574","Providence","Vanderbilt",0,1,1,1
"9575","Providence","Vermont",0,1,1,1
"9576","Providence","Villanova",5,2,0.285714285714286,7
"9577","Providence","Xavier",2,2,0.5,4
"9578","Providence","Yale",0,2,1,2
"9579","Purdue","Arkansas St",0,1,1,1
"9580","Purdue","Ball St",0,1,1,1
"9581","Purdue","Boston College",0,1,1,1
"9582","Purdue","Bucknell",1,0,0,1
"9583","Purdue","Butler",1,0,0,1
"9584","Purdue","BYU",0,1,1,1
"9585","Purdue","Central Conn",0,1,1,1
"9586","Purdue","Clemson",0,1,1,1
"9587","Purdue","E Illinois",0,1,1,1
"9588","Purdue","E Michigan",1,1,0.5,2
"9589","Purdue","Gardner Webb",1,0,0,1
"9590","Purdue","Grambling",0,1,1,1
"9591","Purdue","Hofstra",0,1,1,1
"9592","Purdue","Illinois",2,3,0.6,5
"9593","Purdue","Indiana",2,3,0.6,5
"9594","Purdue","Iowa",2,2,0.5,4
"9595","Purdue","IPFW",0,1,1,1
"9596","Purdue","IUPUI",0,1,1,1
"9597","Purdue","Kansas St",1,0,0,1
"9598","Purdue","Lamar",0,1,1,1
"9599","Purdue","Maryland",1,0,0,1
"9600","Purdue","MD E Shore",0,1,1,1
"9601","Purdue","Michigan",4,1,0.2,5
"9602","Purdue","Michigan St",4,0,0,4
"9603","Purdue","Minnesota",2,3,0.6,5
"9604","Purdue","Missouri",0,1,1,1
"9605","Purdue","NC State",0,1,1,1
"9606","Purdue","Nebraska",1,3,0.75,4
"9607","Purdue","N Kentucky",0,1,1,1
"9608","Purdue","North Florida",1,0,0,1
"9609","Purdue","Northwestern",3,2,0.4,5
"9610","Purdue","Notre Dame",2,0,0,2
"9611","Purdue","Ohio St",5,1,0.166666666666667,6
"9612","Purdue","Oklahoma St",1,0,0,1
"9613","Purdue","Oregon St",1,0,0,1
"9614","Purdue","Penn St",1,5,0.833333333333333,6
"9615","Purdue","Rider",0,1,1,1
"9616","Purdue","Rutgers",0,2,1,2
"9617","Purdue","Samford",0,1,1,1
"9618","Purdue","Siena",0,2,1,2
"9619","Purdue","UNC Wilmington",0,1,1,1
"9620","Purdue","Vanderbilt",1,0,0,1
"9621","Purdue","Villanova",1,0,0,1
"9622","Purdue","Washington St",1,0,0,1
"9623","Purdue","West Virginia",0,2,1,2
"9624","Purdue","William & Mary",0,1,1,1
"9625","Purdue","Wisconsin",4,1,0.2,5
"9626","Purdue","Xavier",1,0,0,1
"9627","Quinnipiac","Albany NY",0,3,1,3
"9628","Quinnipiac","American Univ",1,0,0,1
"9629","Quinnipiac","Boston Univ",3,0,0,3
"9630","Quinnipiac","Bryant",1,1,0.5,2
"9631","Quinnipiac","Canisius",3,1,0.25,4
"9632","Quinnipiac","Central Conn",1,1,0.5,2
"9633","Quinnipiac","Colgate",0,1,1,1
"9634","Quinnipiac","Connecticut",1,0,0,1
"9635","Quinnipiac","Fairfield",1,3,0.75,4
"9636","Quinnipiac","F Dickinson",0,1,1,1
"9637","Quinnipiac","George Mason",1,0,0,1
"9638","Quinnipiac","Hampton",1,1,0.5,2
"9639","Quinnipiac","Hartford",1,2,0.666666666666667,3
"9640","Quinnipiac","Iona",3,2,0.4,5
"9641","Quinnipiac","La Salle",2,0,0,2
"9642","Quinnipiac","Lehigh",2,1,0.333333333333333,3
"9643","Quinnipiac","Long Island",2,1,0.333333333333333,3
"9644","Quinnipiac","Maine",1,2,0.666666666666667,3
"9645","Quinnipiac","Manhattan",2,3,0.6,5
"9646","Quinnipiac","Marist",2,3,0.6,5
"9647","Quinnipiac","Monmouth NJ",0,5,1,5
"9648","Quinnipiac","Mt St Mary's",1,0,0,1
"9649","Quinnipiac","Niagara",1,4,0.8,5
"9650","Quinnipiac","Oregon St",1,1,0.5,2
"9651","Quinnipiac","Rider",3,1,0.25,4
"9652","Quinnipiac","Robert Morris",1,1,0.5,2
"9653","Quinnipiac","Sacred Heart",1,1,0.5,2
"9654","Quinnipiac","Siena",2,2,0.5,4
"9655","Quinnipiac","St Francis NY",1,1,0.5,2
"9656","Quinnipiac","St Francis PA",0,2,1,2
"9657","Quinnipiac","St Peter's",2,2,0.5,4
"9658","Quinnipiac","Vermont",1,2,0.666666666666667,3
"9659","Quinnipiac","Wagner",0,1,1,1
"9660","Quinnipiac","Yale",0,1,1,1
"9661","Radford","Binghamton",0,1,1,1
"9662","Radford","Campbell",3,2,0.4,5
"9663","Radford","Charleston So",2,2,0.5,4
"9664","Radford","Charlotte",1,0,0,1
"9665","Radford","Chattanooga",0,1,1,1
"9666","Radford","Citadel",0,2,1,2
"9667","Radford","Coastal Car",3,0,0,3
"9668","Radford","Cornell",0,2,1,2
"9669","Radford","Delaware",1,0,0,1
"9670","Radford","E Kentucky",1,0,0,1
"9671","Radford","FL Gulf Coast",0,1,1,1
"9672","Radford","Gardner Webb",2,2,0.5,4
"9673","Radford","Georgetown",1,0,0,1
"9674","Radford","G Washington",1,0,0,1
"9675","Radford","Hampton",1,1,0.5,2
"9676","Radford","High Point",1,5,0.833333333333333,6
"9677","Radford","Howard",0,1,1,1
"9678","Radford","James Madison",1,0,0,1
"9679","Radford","Kennesaw",0,1,1,1
"9680","Radford","Liberty",3,3,0.5,6
"9681","Radford","Longwood",2,4,0.666666666666667,6
"9682","Radford","NC A&T",1,2,0.666666666666667,3
"9683","Radford","Presbyterian",0,5,1,5
"9684","Radford","Richmond",1,0,0,1
"9685","Radford","Sacred Heart",0,1,1,1
"9686","Radford","Santa Clara",1,0,0,1
"9687","Radford","Siena",1,1,0.5,2
"9688","Radford","TAM C. Christi",0,1,1,1
"9689","Radford","TCU",1,0,0,1
"9690","Radford","Towson",1,0,0,1
"9691","Radford","UNC Asheville",3,2,0.4,5
"9692","Radford","UNLV",1,0,0,1
"9693","Radford","Virginia Tech",1,1,0.5,2
"9694","Radford","VMI",3,1,0.25,4
"9695","Radford","Wake Forest",1,0,0,1
"9696","Radford","West Virginia",1,0,0,1
"9697","Radford","William & Mary",1,0,0,1
"9698","Radford","Winthrop",1,4,0.8,5
"9699","Radford","Brevard",0,1,1,1
"9700","Radford","Central Penn",0,2,1,2
"9701","Radford","Houghton",0,1,1,1
"9702","Radford","J&W NC",0,1,1,1
"9703","Radford","Catawba",0,1,1,1
"9704","Rhode Island","Arizona",1,0,0,1
"9705","Rhode Island","Auburn",0,1,1,1
"9706","Rhode Island","Brown",0,3,1,3
"9707","Rhode Island","Butler",1,0,0,1
"9708","Rhode Island","Charlotte",1,0,0,1
"9709","Rhode Island","Davidson",1,0,0,1
"9710","Rhode Island","Dayton",3,2,0.4,5
"9711","Rhode Island","Delaware St",0,1,1,1
"9712","Rhode Island","Detroit",1,1,0.5,2
"9713","Rhode Island","Duquesne",1,2,0.666666666666667,3
"9714","Rhode Island","Fordham",2,3,0.6,5
"9715","Rhode Island","George Mason",2,2,0.5,4
"9716","Rhode Island","Georgia St",0,1,1,1
"9717","Rhode Island","Georgia Tech",1,0,0,1
"9718","Rhode Island","G Washington",2,2,0.5,4
"9719","Rhode Island","Kansas",1,0,0,1
"9720","Rhode Island","La Salle",2,2,0.5,4
"9721","Rhode Island","Loyola MD",1,0,0,1
"9722","Rhode Island","LSU",0,1,1,1
"9723","Rhode Island","Maine",0,1,1,1
"9724","Rhode Island","Massachusetts",6,1,0.142857142857143,7
"9725","Rhode Island","McNeese St",0,1,1,1
"9726","Rhode Island","NC A&T",0,1,1,1
"9727","Rhode Island","Nebraska",0,1,1,1
"9728","Rhode Island","New Hampshire",0,1,1,1
"9729","Rhode Island","Norfolk St",1,0,0,1
"9730","Rhode Island","Ohio St",1,0,0,1
"9731","Rhode Island","Providence",3,0,0,3
"9732","Rhode Island","Richmond",1,2,0.666666666666667,3
"9733","Rhode Island","Santa Clara",0,1,1,1
"9734","Rhode Island","Seton Hall",1,0,0,1
"9735","Rhode Island","SMU",1,1,0.5,2
"9736","Rhode Island","Southern Miss",1,1,0.5,2
"9737","Rhode Island","St Bonaventure",1,2,0.666666666666667,3
"9738","Rhode Island","St Joseph's PA",4,1,0.2,5
"9739","Rhode Island","St Louis",1,3,0.75,4
"9740","Rhode Island","St Mary's CA",1,0,0,1
"9741","Rhode Island","Temple",1,0,0,1
"9742","Rhode Island","UNC Asheville",0,1,1,1
"9743","Rhode Island","VA Commonwealth",3,0,0,3
"9744","Rhode Island","Vermont",0,1,1,1
"9745","Rhode Island","Virginia Tech",1,0,0,1
"9746","Rhode Island","Xavier",1,0,0,1
"9747","Rhode Island","MA Lowell",0,2,1,2
"9748","Rhode Island","Metro St",0,1,1,1
"9749","Rhode Island","Pace",0,1,1,1
"9750","Rice","Charlotte",1,2,0.666666666666667,3
"9751","Rice","Chicago St",0,1,1,1
"9752","Rice","Drake",1,0,0,1
"9753","Rice","Drexel",1,0,0,1
"9754","Rice","East Carolina",2,0,0,2
"9755","Rice","FL Atlantic",1,1,0.5,2
"9756","Rice","Florida Intl",2,0,0,2
"9757","Rice","Georgia Tech",1,0,0,1
"9758","Rice","Hartford",1,0,0,1
"9759","Rice","Harvard",2,0,0,2
"9760","Rice","Houston",3,1,0.25,4
"9761","Rice","Houston Bap",2,1,0.333333333333333,3
"9762","Rice","Lamar",1,0,0,1
"9763","Rice","Long Island",1,0,0,1
"9764","Rice","Louisiana Tech",4,0,0,4
"9765","Rice","Marshall",3,0,0,3
"9766","Rice","Memphis",1,0,0,1
"9767","Rice","Mercer",1,0,0,1
"9768","Rice","Middle Tenn St",1,0,0,1
"9769","Rice","New Orleans",0,1,1,1
"9770","Rice","North Texas",3,2,0.4,5
"9771","Rice","Old Dominion",3,0,0,3
"9772","Rice","Oregon St",1,0,0,1
"9773","Rice","Prairie View",0,1,1,1
"9774","Rice","Princeton",1,0,0,1
"9775","Rice","Rider",1,0,0,1
"9776","Rice","Santa Clara",0,1,1,1
"9777","Rice","SE Louisiana",1,0,0,1
"9778","Rice","SMU",2,0,0,2
"9779","Rice","South Alabama",0,1,1,1
"9780","Rice","Southern Miss",2,1,0.333333333333333,3
"9781","Rice","TAM C. Christi",0,1,1,1
"9782","Rice","TCU",1,0,0,1
"9783","Rice","Temple",1,0,0,1
"9784","Rice","Texas",3,0,0,3
"9785","Rice","Texas A&M",1,0,0,1
"9786","Rice","Tulane",3,0,0,3
"9787","Rice","Tulsa",3,0,0,3
"9788","Rice","UAB",2,1,0.333333333333333,3
"9789","Rice","UCF",1,0,0,1
"9790","Rice","UTEP",5,0,0,5
"9791","Rice","UT San Antonio",1,2,0.666666666666667,3
"9792","Rice","Washington St",1,0,0,1
"9793","Rice","William & Mary",1,0,0,1
"9794","Rice","W Kentucky",0,1,1,1
"9795","Rice","AK Anchorage",1,0,0,1
"9796","Rice","Northwood TX",0,1,1,1
"9797","Rice","St Edward's",0,1,1,1
"9798","Rice","St Thomas TX",0,2,1,2
"9799","Rice","MTSU",0,1,1,1
"9800","Richmond","Air Force",0,2,1,2
"9801","Richmond","Belmont",0,1,1,1
"9802","Richmond","Butler",1,0,0,1
"9803","Richmond","Charlotte",0,1,1,1
"9804","Richmond","Coppin St",0,1,1,1
"9805","Richmond","Davidson",2,1,0.333333333333333,3
"9806","Richmond","Dayton",3,1,0.25,4
"9807","Richmond","Delaware",0,1,1,1
"9808","Richmond","Duquesne",0,4,1,4
"9809","Richmond","Fairfield",0,1,1,1
"9810","Richmond","Florida",1,0,0,1
"9811","Richmond","Fordham",0,4,1,4
"9812","Richmond","George Mason",3,1,0.25,4
"9813","Richmond","G Washington",2,2,0.5,4
"9814","Richmond","Hampton",0,1,1,1
"9815","Richmond","High Point",0,1,1,1
"9816","Richmond","Hofstra",0,1,1,1
"9817","Richmond","Howard",0,1,1,1
"9818","Richmond","IUPUI",0,1,1,1
"9819","Richmond","James Madison",1,2,0.666666666666667,3
"9820","Richmond","Kansas",1,0,0,1
"9821","Richmond","La Salle",2,1,0.333333333333333,3
"9822","Richmond","Liberty",0,1,1,1
"9823","Richmond","Massachusetts",1,2,0.666666666666667,3
"9824","Richmond","Minnesota",2,0,0,2
"9825","Richmond","NC State",1,0,0,1
"9826","Richmond","North Carolina",1,0,0,1
"9827","Richmond","Northeastern",1,1,0.5,2
"9828","Richmond","Northern Iowa",1,0,0,1
"9829","Richmond","Ohio",2,0,0,2
"9830","Richmond","Old Dominion",1,2,0.666666666666667,3
"9831","Richmond","Pepperdine",0,1,1,1
"9832","Richmond","Radford",0,1,1,1
"9833","Richmond","Rhode Island",2,1,0.333333333333333,3
"9834","Richmond","South Alabama",0,1,1,1
"9835","Richmond","St Bonaventure",1,4,0.8,5
"9836","Richmond","Stetson",0,1,1,1
"9837","Richmond","St Joseph's PA",1,2,0.666666666666667,3
"9838","Richmond","St Louis",2,1,0.333333333333333,3
"9839","Richmond","Temple",1,0,0,1
"9840","Richmond","UNC Wilmington",0,1,1,1
"9841","Richmond","VA Commonwealth",5,3,0.375,8
"9842","Richmond","Wake Forest",2,1,0.333333333333333,3
"9843","Richmond","William & Mary",0,3,1,3
"9844","Richmond","Wofford",0,1,1,1
"9845","Richmond","Xavier",0,1,1,1
"9846","Rider","Albany NY",1,0,0,1
"9847","Rider","Canisius",3,3,0.5,6
"9848","Rider","Central Conn",0,2,1,2
"9849","Rider","Charleston So",0,1,1,1
"9850","Rider","Delaware",1,0,0,1
"9851","Rider","Drexel",0,1,1,1
"9852","Rider","Fairfield",2,4,0.666666666666667,6
"9853","Rider","Georgia Tech",1,0,0,1
"9854","Rider","Hartford",0,1,1,1
"9855","Rider","Iona",6,1,0.142857142857143,7
"9856","Rider","Jacksonville",0,1,1,1
"9857","Rider","Kansas",1,0,0,1
"9858","Rider","La Salle",1,0,0,1
"9859","Rider","Lehigh",1,1,0.5,2
"9860","Rider","Loyola MD",1,1,0.5,2
"9861","Rider","Manhattan",3,3,0.5,6
"9862","Rider","Marist",1,5,0.833333333333333,6
"9863","Rider","Michigan St",1,0,0,1
"9864","Rider","Monmouth NJ",1,5,0.833333333333333,6
"9865","Rider","Morgan St",0,1,1,1
"9866","Rider","N Dakota St",1,0,0,1
"9867","Rider","Niagara",1,5,0.833333333333333,6
"9868","Rider","Penn",0,2,1,2
"9869","Rider","Princeton",2,0,0,2
"9870","Rider","Purdue",1,0,0,1
"9871","Rider","Quinnipiac",1,3,0.75,4
"9872","Rider","Rice",0,1,1,1
"9873","Rider","Robert Morris",0,1,1,1
"9874","Rider","Rutgers",1,0,0,1
"9875","Rider","Santa Clara",1,0,0,1
"9876","Rider","Siena",3,3,0.5,6
"9877","Rider","SMU",1,0,0,1
"9878","Rider","South Carolina",1,0,0,1
"9879","Rider","Stony Brook",1,0,0,1
"9880","Rider","St Peter's",2,5,0.714285714285714,7
"9881","Rider","Villanova",1,0,0,1
"9882","Rider","Wagner",0,2,1,2
"9883","Rider","WI Milwaukee",0,1,1,1
"9884","Robert Morris","Alabama",1,0,0,1
"9885","Robert Morris","Arkansas",1,0,0,1
"9886","Robert Morris","Bowling Green",0,1,1,1
"9887","Robert Morris","Bradley",0,1,1,1
"9888","Robert Morris","Bryant",2,5,0.714285714285714,7
"9889","Robert Morris","Buffalo",2,0,0,2
"9890","Robert Morris","Campbell",0,2,1,2
"9891","Robert Morris","Central Conn",2,3,0.6,5
"9892","Robert Morris","Chattanooga",1,0,0,1
"9893","Robert Morris","Clemson",1,0,0,1
"9894","Robert Morris","Cleveland St",1,1,0.5,2
"9895","Robert Morris","Delaware",1,1,0.5,2
"9896","Robert Morris","Duquesne",0,3,1,3
"9897","Robert Morris","E Michigan",1,0,0,1
"9898","Robert Morris","F Dickinson",0,6,1,6
"9899","Robert Morris","Fordham",0,1,1,1
"9900","Robert Morris","Georgetown",1,0,0,1
"9901","Robert Morris","Hampton",0,1,1,1
"9902","Robert Morris","Kentucky",1,0,0,1
"9903","Robert Morris","Lafayette",1,1,0.5,2
"9904","Robert Morris","Lehigh",1,0,0,1
"9905","Robert Morris","Long Island",2,3,0.6,5
"9906","Robert Morris","Monmouth NJ",0,2,1,2
"9907","Robert Morris","Mt St Mary's",2,5,0.714285714285714,7
"9908","Robert Morris","North Carolina",1,0,0,1
"9909","Robert Morris","Oakland",1,0,0,1
"9910","Robert Morris","Ohio",0,1,1,1
"9911","Robert Morris","Oklahoma St",1,0,0,1
"9912","Robert Morris","Quinnipiac",1,1,0.5,2
"9913","Robert Morris","Rider",1,0,0,1
"9914","Robert Morris","Sacred Heart",1,5,0.833333333333333,6
"9915","Robert Morris","Savannah St",1,1,0.5,2
"9916","Robert Morris","St Francis NY",2,5,0.714285714285714,7
"9917","Robert Morris","St Francis PA",1,6,0.857142857142857,7
"9918","Robert Morris","Toledo",2,0,0,2
"9919","Robert Morris","ULL",0,1,1,1
"9920","Robert Morris","ULM",0,1,1,1
"9921","Robert Morris","UT Arlington",0,1,1,1
"9922","Robert Morris","Wagner",1,5,0.833333333333333,6
"9923","Robert Morris","Xavier",1,0,0,1
"9924","Robert Morris","Youngstown St",2,0,0,2
"9925","Rutgers","Army",0,1,1,1
"9926","Rutgers","Boston Univ",0,1,1,1
"9927","Rutgers","Canisius",0,1,1,1
"9928","Rutgers","Cincinnati",4,0,0,4
"9929","Rutgers","Clemson",0,1,1,1
"9930","Rutgers","Connecticut",3,0,0,3
"9931","Rutgers","DePaul",1,0,0,1
"9932","Rutgers","Drexel",1,0,0,1
"9933","Rutgers","F Dickinson",1,1,0.5,2
"9934","Rutgers","Florida A&M",0,1,1,1
"9935","Rutgers","Georgetown",2,0,0,2
"9936","Rutgers","G Washington",2,1,0.333333333333333,3
"9937","Rutgers","Houston",1,1,0.5,2
"9938","Rutgers","Howard",0,1,1,1
"9939","Rutgers","Illinois",1,0,0,1
"9940","Rutgers","Indiana",2,0,0,2
"9941","Rutgers","Iona",0,1,1,1
"9942","Rutgers","Iowa",1,0,0,1
"9943","Rutgers","Louisville",4,0,0,4
"9944","Rutgers","Manhattan",0,1,1,1
"9945","Rutgers","Marquette",1,0,0,1
"9946","Rutgers","Maryland",2,0,0,2
"9947","Rutgers","Memphis",2,0,0,2
"9948","Rutgers","Michigan",2,0,0,2
"9949","Rutgers","Michigan St",1,0,0,1
"9950","Rutgers","Minnesota",2,0,0,2
"9951","Rutgers","Mississippi",1,0,0,1
"9952","Rutgers","Monmouth NJ",0,1,1,1
"9953","Rutgers","Nebraska",1,0,0,1
"9954","Rutgers","New Hampshire",0,1,1,1
"9955","Rutgers","Northwestern",1,0,0,1
"9956","Rutgers","Notre Dame",1,0,0,1
"9957","Rutgers","Ohio St",1,0,0,1
"9958","Rutgers","Penn St",1,1,0.5,2
"9959","Rutgers","Pittsburgh",0,1,1,1
"9960","Rutgers","Princeton",1,1,0.5,2
"9961","Rutgers","Providence",1,0,0,1
"9962","Rutgers","Purdue",2,0,0,2
"9963","Rutgers","Rider",0,1,1,1
"9964","Rutgers","Sacred Heart",0,2,1,2
"9965","Rutgers","Seton Hall",2,2,0.5,4
"9966","Rutgers","SMU",2,0,0,2
"9967","Rutgers","South Florida",0,4,1,4
"9968","Rutgers","St Francis NY",0,1,1,1
"9969","Rutgers","St Francis PA",1,0,0,1
"9970","Rutgers","St John's",1,1,0.5,2
"9971","Rutgers","St Peter's",2,0,0,2
"9972","Rutgers","Syracuse",1,0,0,1
"9973","Rutgers","Temple",1,1,0.5,2
"9974","Rutgers","UAB",1,1,0.5,2
"9975","Rutgers","UCF",1,1,0.5,2
"9976","Rutgers","UNC Greensboro",0,2,1,2
"9977","Rutgers","Vanderbilt",0,1,1,1
"9978","Rutgers","Villanova",1,0,0,1
"9979","Rutgers","Virginia",1,0,0,1
"9980","Rutgers","William & Mary",1,0,0,1
"9981","Rutgers","Wisconsin",0,1,1,1
"9982","Rutgers","Yale",0,1,1,1
"9983","Rutgers","Stillman",0,1,1,1
"9984","Sacred Heart","Boston College",1,0,0,1
"9985","Sacred Heart","Brown",3,0,0,3
"9986","Sacred Heart","Bryant",4,3,0.428571428571429,7
"9987","Sacred Heart","Campbell",0,1,1,1
"9988","Sacred Heart","Central Conn",5,1,0.166666666666667,6
"9989","Sacred Heart","Colgate",0,1,1,1
"9990","Sacred Heart","Fairfield",1,0,0,1
"9991","Sacred Heart","F Dickinson",1,4,0.8,5
"9992","Sacred Heart","Florida A&M",1,0,0,1
"9993","Sacred Heart","Fordham",0,1,1,1
"9994","Sacred Heart","G Washington",1,0,0,1
"9995","Sacred Heart","Hartford",2,1,0.333333333333333,3
"9996","Sacred Heart","Hofstra",0,1,1,1
"9997","Sacred Heart","Holy Cross",2,1,0.333333333333333,3
"9998","Sacred Heart","James Madison",1,0,0,1
"9999","Sacred Heart","Lafayette",3,0,0,3
"10000","Sacred Heart","La Salle",1,0,0,1
"10001","Sacred Heart","Lehigh",2,0,0,2
"10002","Sacred Heart","Long Island",3,2,0.4,5
"10003","Sacred Heart","Monmouth NJ",0,1,1,1
"10004","Sacred Heart","Mt St Mary's",3,2,0.4,5
"10005","Sacred Heart","New Hampshire",0,2,1,2
"10006","Sacred Heart","Ohio St",1,0,0,1
"10007","Sacred Heart","Quinnipiac",1,1,0.5,2
"10008","Sacred Heart","Radford",1,0,0,1
"10009","Sacred Heart","Robert Morris",5,1,0.166666666666667,6
"10010","Sacred Heart","Rutgers",2,0,0,2
"10011","Sacred Heart","Santa Clara",1,0,0,1
"10012","Sacred Heart","St Francis NY",5,1,0.166666666666667,6
"10013","Sacred Heart","St Francis PA",4,1,0.2,5
"10014","Sacred Heart","Stony Brook",1,1,0.5,2
"10015","Sacred Heart","UNLV",1,0,0,1
"10016","Sacred Heart","Wagner",4,1,0.2,5
"10017","Sacred Heart","Yale",2,1,0.333333333333333,3
"10018","Sacred Heart","MA Lowell",1,0,0,1
"10019","Sacred Heart","Mitchell",0,1,1,1
"10020","Samford","Alcorn St",1,0,0,1
"10021","Samford","Appalachian St",3,2,0.4,5
"10022","Samford","Austin Peay",1,2,0.666666666666667,3
"10023","Samford","Bowling Green",1,0,0,1
"10024","Samford","Campbell",0,1,1,1
"10025","Samford","Chattanooga",5,1,0.166666666666667,6
"10026","Samford","Citadel",3,2,0.4,5
"10027","Samford","Col Charleston",1,1,0.5,2
"10028","Samford","CS Northridge",1,0,0,1
"10029","Samford","Davidson",3,0,0,3
"10030","Samford","Elon",3,1,0.25,4
"10031","Samford","ETSU",2,1,0.333333333333333,3
"10032","Samford","FL Gulf Coast",2,0,0,2
"10033","Samford","Furman",1,4,0.8,5
"10034","Samford","Ga Southern",1,1,0.5,2
"10035","Samford","Indiana",1,0,0,1
"10036","Samford","Jacksonville",0,2,1,2
"10037","Samford","Kennesaw",1,0,0,1
"10038","Samford","Kentucky",1,0,0,1
"10039","Samford","Louisiana Tech",1,0,0,1
"10040","Samford","Louisville",1,0,0,1
"10041","Samford","Marquette",1,0,0,1
"10042","Samford","Memphis",1,0,0,1
"10043","Samford","Mercer",2,0,0,2
"10044","Samford","Missouri KC",0,1,1,1
"10045","Samford","Pittsburgh",1,0,0,1
"10046","Samford","Presbyterian",0,2,1,2
"10047","Samford","Purdue",1,0,0,1
"10048","Samford","Sam Houston St",1,0,0,1
"10049","Samford","SF Austin",1,0,0,1
"10050","Samford","TN Martin",1,1,0.5,2
"10051","Samford","Toledo",1,0,0,1
"10052","Samford","ULM",1,1,0.5,2
"10053","Samford","UNC Greensboro",3,3,0.5,6
"10054","Samford","UT Arlington",2,0,0,2
"10055","Samford","VMI",1,1,0.5,2
"10056","Samford","Wake Forest",1,0,0,1
"10057","Samford","W Carolina",2,4,0.666666666666667,6
"10058","Samford","Wisconsin",1,0,0,1
"10059","Samford","W Kentucky",1,0,0,1
"10060","Samford","Wofford",4,1,0.2,5
"10061","Samford","Auburn M'gomery",0,1,1,1
"10062","Samford","Campbellsville",0,1,1,1
"10063","Samford","Kentucky St",0,1,1,1
"10064","Samford","Martin Meth",0,1,1,1
"10065","Sam Houston St","Arkansas",1,0,0,1
"10066","Sam Houston St","Ark Pine Bluff",0,1,1,1
"10067","Sam Houston St","Cent Arkansas",1,4,0.8,5
"10068","Sam Houston St","E Washington",1,1,0.5,2
"10069","Sam Houston St","Fairfield",0,1,1,1
"10070","Sam Houston St","Houston Bap",0,4,1,4
"10071","Sam Houston St","Indiana",1,0,0,1
"10072","Sam Houston St","James Madison",0,1,1,1
"10073","Sam Houston St","Lamar",0,6,1,6
"10074","Sam Houston St","Liberty",1,1,0.5,2
"10075","Sam Houston St","Long Island",0,1,1,1
"10076","Sam Houston St","LSU",1,0,0,1
"10077","Sam Houston St","McNeese St",1,3,0.75,4
"10078","Sam Houston St","New Orleans",0,3,1,3
"10079","Sam Houston St","Nicholls St",2,2,0.5,4
"10080","Sam Houston St","Northern Arizona",1,0,0,1
"10081","Sam Houston St","Northwestern LA",2,3,0.6,5
"10082","Sam Houston St","Oral Roberts",3,1,0.25,4
"10083","Sam Houston St","Prairie View",0,2,1,2
"10084","Sam Houston St","Samford",0,1,1,1
"10085","Sam Houston St","SE Louisiana",1,4,0.8,5
"10086","Sam Houston St","SF Austin",8,0,0,8
"10087","Sam Houston St","SMU",1,0,0,1
"10088","Sam Houston St","South Dakota",0,1,1,1
"10089","Sam Houston St","Southern Miss",1,0,0,1
"10090","Sam Houston St","TAM C. Christi",1,6,0.857142857142857,7
"10091","Sam Houston St","Texas",1,0,0,1
"10092","Sam Houston St","Texas A&M",2,0,0,2
"10093","Sam Houston St","Toledo",1,0,0,1
"10094","Sam Houston St","Towson",0,1,1,1
"10095","Sam Houston St","TX Pan American",0,2,1,2
"10096","Sam Houston St","UC Irvine",0,1,1,1
"10097","Sam Houston St","UNLV",1,0,0,1
"10098","Sam Houston St","Wofford",1,0,0,1
"10099","Sam Houston St","Abilene Chr",0,3,1,3
"10100","Sam Houston St","Hillsdale Bap",0,1,1,1
"10101","Sam Houston St","Howard Payne",0,1,1,1
"10102","Sam Houston St","Incarnate Word",1,1,0.5,2
"10103","Sam Houston St","Jarvis Chr",0,1,1,1
"10104","Sam Houston St","Austin Col",0,1,1,1
"10105","Sam Houston St","Texas Col",0,1,1,1
"10106","Sam Houston St","Univ of Southwest",0,1,1,1
"10107","San Diego","Boise St",1,0,0,1
"10108","San Diego","BYU",4,2,0.333333333333333,6
"10109","San Diego","CS Northridge",1,0,0,1
"10110","San Diego","Florida A&M",0,1,1,1
"10111","San Diego","Gonzaga",5,1,0.166666666666667,6
"10112","San Diego","IL Chicago",1,0,0,1
"10113","San Diego","James Madison",1,0,0,1
"10114","San Diego","Loy Marymount",2,4,0.666666666666667,6
"10115","San Diego","Montana",1,0,0,1
"10116","San Diego","Morgan St",0,2,1,2
"10117","San Diego","New Mexico",1,0,0,1
"10118","San Diego","New Orleans",0,1,1,1
"10119","San Diego","N Kentucky",0,2,1,2
"10120","San Diego","Oregon St",1,0,0,1
"10121","San Diego","Pacific",2,2,0.5,4
"10122","San Diego","Pepperdine",4,3,0.428571428571429,7
"10123","San Diego","Portland",2,4,0.666666666666667,6
"10124","San Diego","Princeton",0,1,1,1
"10125","San Diego","San Diego St",3,0,0,3
"10126","San Diego","San Francisco",4,3,0.428571428571429,7
"10127","San Diego","Santa Barbara",2,1,0.333333333333333,3
"10128","San Diego","Santa Clara",4,2,0.333333333333333,6
"10129","San Diego","S Dakota St",0,1,1,1
"10130","San Diego","SE Missouri St",0,1,1,1
"10131","San Diego","SF Austin",1,0,0,1
"10132","San Diego","Siena",0,1,1,1
"10133","San Diego","S Illinois",0,1,1,1
"10134","San Diego","Southern Utah",0,2,1,2
"10135","San Diego","St Mary's CA",5,1,0.166666666666667,6
"10136","San Diego","Tulane",0,1,1,1
"10137","San Diego","Tulsa",1,0,0,1
"10138","San Diego","UCLA",1,0,0,1
"10139","San Diego","UNC Greensboro",0,1,1,1
"10140","San Diego","W Michigan",1,1,0.5,2
"10141","San Diego","Xavier",1,0,0,1
"10142","San Diego","Grand Canyon",0,1,1,1
"10143","San Diego","Pacifica",0,1,1,1
"10144","San Diego","San Diego Chr",0,2,1,2
"10145","San Diego St","Air Force",1,5,0.833333333333333,6
"10146","San Diego St","Arizona",3,0,0,3
"10147","San Diego St","Ark Pine Bluff",0,1,1,1
"10148","San Diego St","Ball St",0,1,1,1
"10149","San Diego St","Boise St",3,3,0.5,6
"10150","San Diego St","BYU",0,1,1,1
"10151","San Diego St","Cincinnati",1,0,0,1
"10152","San Diego St","Col Charleston",0,1,1,1
"10153","San Diego St","Colorado St",2,5,0.714285714285714,7
"10154","San Diego St","Creighton",0,1,1,1
"10155","San Diego St","CS Bakersfield",0,2,1,2
"10156","San Diego St","CS Northridge",0,1,1,1
"10157","San Diego St","Fresno St",1,5,0.833333333333333,6
"10158","San Diego St","Indiana St",0,1,1,1
"10159","San Diego St","Kansas",0,1,1,1
"10160","San Diego St","Long Beach St",0,1,1,1
"10161","San Diego St","Marquette",0,1,1,1
"10162","San Diego St","McNeese St",0,1,1,1
"10163","San Diego St","Missouri St",0,1,1,1
"10164","San Diego St","Nevada",0,5,1,5
"10165","San Diego St","New Mexico",3,4,0.571428571428571,7
"10166","San Diego St","Pittsburgh",0,1,1,1
"10167","San Diego St","San Diego",0,3,1,3
"10168","San Diego St","San Francisco",0,1,1,1
"10169","San Diego St","San Jose St",0,3,1,3
"10170","San Diego St","Santa Barbara",0,1,1,1
"10171","San Diego St","Southern Utah",0,1,1,1
"10172","San Diego St","Syracuse",1,0,0,1
"10173","San Diego St","TX Southern",0,1,1,1
"10174","San Diego St","UCLA",0,1,1,1
"10175","San Diego St","UC Riverside",0,2,1,2
"10176","San Diego St","UNLV",2,6,0.75,8
"10177","San Diego St","USC",0,1,1,1
"10178","San Diego St","Utah",0,1,1,1
"10179","San Diego St","Utah St",0,4,1,4
"10180","San Diego St","Washington",1,1,0.5,2
"10181","San Diego St","Wyoming",3,3,0.5,6
"10182","San Diego St","San Diego Chr",0,2,1,2
"10183","San Diego St","St Katherine",0,1,1,1
"10184","San Francisco","American Univ",0,2,1,2
"10185","San Francisco","BYU",6,1,0.142857142857143,7
"10186","San Francisco","Cal Poly SLO",1,0,0,1
"10187","San Francisco","Cleveland St",1,1,0.5,2
"10188","San Francisco","Colorado",1,0,0,1
"10189","San Francisco","Columbia",0,1,1,1
"10190","San Francisco","ETSU",0,1,1,1
"10191","San Francisco","Evansville",1,0,0,1
"10192","San Francisco","E Washington",1,0,0,1
"10193","San Francisco","FL Gulf Coast",1,0,0,1
"10194","San Francisco","Gonzaga",7,0,0,7
"10195","San Francisco","Hawaii",0,1,1,1
"10196","San Francisco","Holy Cross",1,0,0,1
"10197","San Francisco","Houston Bap",0,1,1,1
"10198","San Francisco","Idaho St",1,0,0,1
"10199","San Francisco","Illinois St",1,0,0,1
"10200","San Francisco","Loy Marymount",1,5,0.833333333333333,6
"10201","San Francisco","Mississippi",1,0,0,1
"10202","San Francisco","Montana",0,3,1,3
"10203","San Francisco","Nevada",2,0,0,2
"10204","San Francisco","Nicholls St",0,1,1,1
"10205","San Francisco","Oregon",1,0,0,1
"10206","San Francisco","Pacific",1,5,0.833333333333333,6
"10207","San Francisco","Pepperdine",0,6,1,6
"10208","San Francisco","Portland",2,4,0.666666666666667,6
"10209","San Francisco","Portland St",0,1,1,1
"10210","San Francisco","San Diego",3,4,0.571428571428571,7
"10211","San Francisco","San Diego St",1,0,0,1
"10212","San Francisco","Santa Clara",3,3,0.5,6
"10213","San Francisco","S Carolina St",0,1,1,1
"10214","San Francisco","Stanford",1,0,0,1
"10215","San Francisco","St John's",1,1,0.5,2
"10216","San Francisco","St Mary's CA",5,1,0.166666666666667,6
"10217","San Francisco","Vermont",0,1,1,1
"10218","San Francisco","Notre Dame CA",0,2,1,2
"10219","San Francisco","Sonoma St",0,1,1,1
"10220","San Jose St","Air Force",4,0,0,4
"10221","San Jose St","Boise St",4,0,0,4
"10222","San Jose St","Colorado St",4,0,0,4
"10223","San Jose St","CS Fullerton",1,1,0.5,2
"10224","San Jose St","CS Sacramento",0,1,1,1
"10225","San Jose St","Denver",2,0,0,2
"10226","San Jose St","Fresno St",4,0,0,4
"10227","San Jose St","Houston",1,1,0.5,2
"10228","San Jose St","Idaho",2,0,0,2
"10229","San Jose St","James Madison",2,0,0,2
"10230","San Jose St","Kansas",1,0,0,1
"10231","San Jose St","Louisiana Tech",2,0,0,2
"10232","San Jose St","Montana St",0,1,1,1
"10233","San Jose St","Nevada",3,1,0.25,4
"10234","San Jose St","New Mexico",3,0,0,3
"10235","San Jose St","New Mexico St",2,0,0,2
"10236","San Jose St","New Orleans",1,1,0.5,2
"10237","San Jose St","N Illinois",1,0,0,1
"10238","San Jose St","Pepperdine",1,1,0.5,2
"10239","San Jose St","Portland",2,0,0,2
"10240","San Jose St","Princeton",1,0,0,1
"10241","San Jose St","San Diego St",3,0,0,3
"10242","San Jose St","Santa Clara",3,0,0,3
"10243","San Jose St","Seattle",2,1,0.333333333333333,3
"10244","San Jose St","Texas St",1,1,0.5,2
"10245","San Jose St","UC Davis",1,2,0.666666666666667,3
"10246","San Jose St","UNLV",3,0,0,3
"10247","San Jose St","Utah St",6,0,0,6
"10248","San Jose St","UT Arlington",2,0,0,2
"10249","San Jose St","UT San Antonio",0,1,1,1
"10250","San Jose St","Washington",1,0,0,1
"10251","San Jose St","Washington St",1,0,0,1
"10252","San Jose St","Weber St",1,1,0.5,2
"10253","San Jose St","WI Milwaukee",1,0,0,1
"10254","San Jose St","W Michigan",1,0,0,1
"10255","San Jose St","Wyoming",4,0,0,4
"10256","San Jose St","Bethesda",0,1,1,1
"10257","San Jose St","Pacifica",0,1,1,1
"10258","San Jose St","St Katherine",0,1,1,1
"10259","San Jose St","Westminster UT",0,1,1,1
"10260","Santa Barbara","Boise St",1,0,0,1
"10261","Santa Barbara","California",1,1,0.5,2
"10262","Santa Barbara","Cal Poly SLO",3,5,0.625,8
"10263","Santa Barbara","Colorado",1,0,0,1
"10264","Santa Barbara","Colorado St",1,0,0,1
"10265","Santa Barbara","CS Fullerton",2,4,0.666666666666667,6
"10266","Santa Barbara","CS Northridge",3,3,0.5,6
"10267","Santa Barbara","CS Sacramento",1,0,0,1
"10268","Santa Barbara","FL Gulf Coast",1,1,0.5,2
"10269","Santa Barbara","Hawaii",2,4,0.666666666666667,6
"10270","Santa Barbara","Illinois St",1,0,0,1
"10271","Santa Barbara","Kansas",1,0,0,1
"10272","Santa Barbara","Long Beach St",3,3,0.5,6
"10273","Santa Barbara","LSU",1,0,0,1
"10274","Santa Barbara","Mercer",0,1,1,1
"10275","Santa Barbara","Oregon",1,0,0,1
"10276","Santa Barbara","Oregon St",1,0,0,1
"10277","Santa Barbara","Pacific",1,1,0.5,2
"10278","Santa Barbara","San Diego",1,2,0.666666666666667,3
"10279","Santa Barbara","San Diego St",1,0,0,1
"10280","Santa Barbara","Santa Clara",0,1,1,1
"10281","Santa Barbara","S Dakota St",0,1,1,1
"10282","Santa Barbara","Seattle",0,2,1,2
"10283","Santa Barbara","SMU",1,0,0,1
"10284","Santa Barbara","Troy",0,1,1,1
"10285","Santa Barbara","UC Davis",2,4,0.666666666666667,6
"10286","Santa Barbara","UC Irvine",4,3,0.428571428571429,7
"10287","Santa Barbara","UCLA",1,0,0,1
"10288","Santa Barbara","UC Riverside",2,4,0.666666666666667,6
"10289","Santa Barbara","UNLV",0,1,1,1
"10290","Santa Barbara","Utah St",2,0,0,2
"10291","Santa Barbara","Vermont",0,1,1,1
"10292","Santa Barbara","Washington St",0,1,1,1
"10293","Santa Barbara","W Illinois",0,1,1,1
"10294","Santa Barbara","Wyoming",2,0,0,2
"10295","Santa Barbara","Hawaii Pacific",0,1,1,1
"10296","Santa Barbara","San Diego Chr",0,1,1,1
"10297","Santa Barbara","The Master's",0,2,1,2
"10298","Santa Clara","Alcorn St",0,1,1,1
"10299","Santa Clara","BYU",7,0,0,7
"10300","Santa Clara","Cal Poly SLO",2,1,0.333333333333333,3
"10301","Santa Clara","CS Bakersfield",0,2,1,2
"10302","Santa Clara","CS Fullerton",1,1,0.5,2
"10303","Santa Clara","Duke",1,0,0,1
"10304","Santa Clara","E Washington",0,1,1,1
"10305","Santa Clara","Gonzaga",7,0,0,7
"10306","Santa Clara","Loy Marymount",2,5,0.714285714285714,7
"10307","Santa Clara","Michigan St",1,0,0,1
"10308","Santa Clara","N Dakota St",1,0,0,1
"10309","Santa Clara","Northeastern",1,0,0,1
"10310","Santa Clara","Notre Dame",1,0,0,1
"10311","Santa Clara","Pacific",2,4,0.666666666666667,6
"10312","Santa Clara","Pepperdine",2,4,0.666666666666667,6
"10313","Santa Clara","Portland",3,3,0.5,6
"10314","Santa Clara","Radford",0,1,1,1
"10315","Santa Clara","Rhode Island",1,0,0,1
"10316","Santa Clara","Rice",1,0,0,1
"10317","Santa Clara","Rider",0,1,1,1
"10318","Santa Clara","Sacred Heart",0,1,1,1
"10319","Santa Clara","San Diego",2,4,0.666666666666667,6
"10320","Santa Clara","San Francisco",3,3,0.5,6
"10321","Santa Clara","San Jose St",0,3,1,3
"10322","Santa Clara","Santa Barbara",1,0,0,1
"10323","Santa Clara","SC Upstate",0,1,1,1
"10324","Santa Clara","South Florida",0,1,1,1
"10325","Santa Clara","St Louis",0,1,1,1
"10326","Santa Clara","St Mary's CA",4,2,0.333333333333333,6
"10327","Santa Clara","Tennessee",1,0,0,1
"10328","Santa Clara","UNLV",1,0,0,1
"10329","Santa Clara","Utah St",2,0,0,2
"10330","Santa Clara","Utah Valley",0,1,1,1
"10331","Santa Clara","Wagner",0,1,1,1
"10332","Santa Clara","Washington St",0,1,1,1
"10333","Santa Clara","Bethesda",0,1,1,1
"10334","Santa Clara","La Sierra",0,1,1,1
"10335","Santa Clara","San Diego Chr",0,1,1,1
"10336","Santa Clara","St Katherine",0,1,1,1
"10337","Savannah St","Alabama St",0,1,1,1
"10338","Savannah St","Arkansas",1,0,0,1
"10339","Savannah St","Baylor",1,0,0,1
"10340","Savannah St","Bethune-Cookman",1,4,0.8,5
"10341","Savannah St","Campbell",0,1,1,1
"10342","Savannah St","Cleveland St",0,1,1,1
"10343","Savannah St","Coppin St",0,3,1,3
"10344","Savannah St","Delaware St",3,0,0,3
"10345","Savannah St","E Kentucky",1,0,0,1
"10346","Savannah St","Florida",2,0,0,2
"10347","Savannah St","Florida A&M",2,4,0.666666666666667,6
"10348","Savannah St","Hampton",2,1,0.333333333333333,3
"10349","Savannah St","Howard",1,2,0.666666666666667,3
"10350","Savannah St","Indiana",1,0,0,1
"10351","Savannah St","Jacksonville St",1,0,0,1
"10352","Savannah St","Kansas St",1,0,0,1
"10353","Savannah St","Lamar",1,0,0,1
"10354","Savannah St","Louisville",1,0,0,1
"10355","Savannah St","LSU",1,0,0,1
"10356","Savannah St","Marquette",1,0,0,1
"10357","Savannah St","Marshall",2,0,0,2
"10358","Savannah St","MD E Shore",1,2,0.666666666666667,3
"10359","Savannah St","Miami FL",2,0,0,2
"10360","Savannah St","Middle Tenn St",1,0,0,1
"10361","Savannah St","Morgan St",1,1,0.5,2
"10362","Savannah St","NC A&T",3,3,0.5,6
"10363","Savannah St","NC Central",5,1,0.166666666666667,6
"10364","Savannah St","Norfolk St",4,0,0,4
"10365","Savannah St","Northern Iowa",1,0,0,1
"10366","Savannah St","North Florida",2,1,0.333333333333333,3
"10367","Savannah St","Ohio St",1,0,0,1
"10368","Savannah St","Pittsburgh",1,0,0,1
"10369","Savannah St","Robert Morris",1,1,0.5,2
"10370","Savannah St","S Carolina St",1,6,0.857142857142857,7
"10371","Savannah St","St Louis",1,0,0,1
"10372","Savannah St","Tulane",1,0,0,1
"10373","Savannah St","UCF",1,0,0,1
"10374","Savannah St","Utah",1,0,0,1
"10375","Savannah St","W Illinois",1,1,0.5,2
"10376","Savannah St","Winthrop",1,1,0.5,2
"10377","Savannah St","Allen",0,1,1,1
"10378","Savannah St","Florida National",0,1,1,1
"10379","Savannah St","Grand Canyon",1,0,0,1
"10380","Savannah St","TN Temple",0,1,1,1
"10381","Savannah St","Mid Georgia",0,1,1,1
"10382","S Carolina St","Albany NY",2,0,0,2
"10383","S Carolina St","Bethune-Cookman",4,2,0.333333333333333,6
"10384","S Carolina St","Clemson",2,0,0,2
"10385","S Carolina St","Coastal Car",2,2,0.5,4
"10386","S Carolina St","Col Charleston",1,0,0,1
"10387","S Carolina St","Coppin St",3,0,0,3
"10388","S Carolina St","Delaware St",2,2,0.5,4
"10389","S Carolina St","E Kentucky",1,0,0,1
"10390","S Carolina St","Florida A&M",3,2,0.4,5
"10391","S Carolina St","Fordham",1,0,0,1
"10392","S Carolina St","Ga Southern",2,0,0,2
"10393","S Carolina St","Hampton",2,1,0.333333333333333,3
"10394","S Carolina St","Houston",0,1,1,1
"10395","S Carolina St","Howard",2,0,0,2
"10396","S Carolina St","Iowa",1,0,0,1
"10397","S Carolina St","Jacksonville",1,1,0.5,2
"10398","S Carolina St","Kennesaw",1,0,0,1
"10399","S Carolina St","Marshall",1,0,0,1
"10400","S Carolina St","Maryland",1,0,0,1
"10401","S Carolina St","MD E Shore",1,2,0.666666666666667,3
"10402","S Carolina St","Michigan",1,0,0,1
"10403","S Carolina St","Missouri",1,0,0,1
"10404","S Carolina St","Morgan St",3,0,0,3
"10405","S Carolina St","NC A&T",2,4,0.666666666666667,6
"10406","S Carolina St","NC Central",5,0,0,5
"10407","S Carolina St","Nebraska",1,0,0,1
"10408","S Carolina St","NE Omaha",2,0,0,2
"10409","S Carolina St","NJIT",1,1,0.5,2
"10410","S Carolina St","Norfolk St",3,1,0.25,4
"10411","S Carolina St","San Francisco",1,0,0,1
"10412","S Carolina St","Savannah St",6,1,0.142857142857143,7
"10413","S Carolina St","South Carolina",2,0,0,2
"10414","S Carolina St","Southern Utah",1,0,0,1
"10415","S Carolina St","Texas Tech",1,0,0,1
"10416","S Carolina St","Virginia",1,0,0,1
"10417","S Carolina St","Washington",1,0,0,1
"10418","S Carolina St","Abilene Chr",1,0,0,1
"10419","S Carolina St","Columbia Intl",0,1,1,1
"10420","S Carolina St","St Andrew's",0,2,1,2
"10421","S Carolina St","Voorhees",0,1,1,1
"10422","SC Upstate","Baylor",1,0,0,1
"10423","SC Upstate","Charlotte",1,0,0,1
"10424","SC Upstate","Cincinnati",1,0,0,1
"10425","SC Upstate","CS Fullerton",0,1,1,1
"10426","SC Upstate","ETSU",0,4,1,4
"10427","SC Upstate","E Washington",1,0,0,1
"10428","SC Upstate","FL Gulf Coast",6,1,0.142857142857143,7
"10429","SC Upstate","Florida A&M",0,1,1,1
"10430","SC Upstate","Florida Intl",0,1,1,1
"10431","SC Upstate","Georgia Tech",0,1,1,1
"10432","SC Upstate","Hampton",0,2,1,2
"10433","SC Upstate","Jacksonville",3,3,0.5,6
"10434","SC Upstate","Kansas St",1,0,0,1
"10435","SC Upstate","Kennesaw",1,6,0.857142857142857,7
"10436","SC Upstate","Kent",1,0,0,1
"10437","SC Upstate","Lipscomb",2,4,0.666666666666667,6
"10438","SC Upstate","Maryland",1,0,0,1
"10439","SC Upstate","Memphis",1,0,0,1
"10440","SC Upstate","Mercer",5,1,0.166666666666667,6
"10441","SC Upstate","Mississippi St",0,1,1,1
"10442","SC Upstate","Missouri KC",0,1,1,1
"10443","SC Upstate","NC A&T",0,2,1,2
"10444","SC Upstate","Niagara",0,1,1,1
"10445","SC Upstate","N Kentucky",3,3,0.5,6
"10446","SC Upstate","North Florida",2,6,0.75,8
"10447","SC Upstate","Santa Clara",1,0,0,1
"10448","SC Upstate","South Carolina",0,1,1,1
"10449","SC Upstate","Stetson",3,3,0.5,6
"10450","SC Upstate","St Louis",1,0,0,1
"10451","SC Upstate","Tennessee",1,0,0,1
"10452","SC Upstate","Tennessee St",1,1,0.5,2
"10453","SC Upstate","UCF",1,0,0,1
"10454","SC Upstate","UNC Asheville",1,1,0.5,2
"10455","SC Upstate","Utah Valley",0,1,1,1
"10456","SC Upstate","UT San Antonio",1,1,0.5,2
"10457","SC Upstate","Virginia Tech",0,1,1,1
"10458","SC Upstate","W Carolina",0,1,1,1
"10459","SC Upstate","Winthrop",1,0,0,1
"10460","SC Upstate","Wright St",1,0,0,1
"10461","SC Upstate","Barber-Scotia",0,1,1,1
"10462","SC Upstate","B Jones",0,1,1,1
"10463","SC Upstate","Montreat And",0,1,1,1
"10464","SC Upstate","North Greenville",0,1,1,1
"10465","SC Upstate","St Andrew's",0,1,1,1
"10466","SC Upstate","Bob Jones",0,1,1,1
"10467","S Dakota St","Alabama",1,0,0,1
"10468","S Dakota St","Belmont",1,1,0.5,2
"10469","S Dakota St","Buffalo",1,0,0,1
"10470","S Dakota St","CS Bakersfield",1,2,0.666666666666667,3
"10471","S Dakota St","Denver",1,3,0.75,4
"10472","S Dakota St","FL Gulf Coast",1,0,0,1
"10473","S Dakota St","Hofstra",1,0,0,1
"10474","S Dakota St","Howard",0,1,1,1
"10475","S Dakota St","Idaho",1,1,0.5,2
"10476","S Dakota St","Idaho St",0,1,1,1
"10477","S Dakota St","IPFW",3,4,0.571428571428571,7
"10478","S Dakota St","IUPUI",0,6,1,6
"10479","S Dakota St","Lehigh",0,1,1,1
"10480","S Dakota St","Loy Marymount",1,0,0,1
"10481","S Dakota St","Marshall",0,1,1,1
"10482","S Dakota St","Minnesota",2,0,0,2
"10483","S Dakota St","Missouri KC",0,4,1,4
"10484","S Dakota St","Montana",1,1,0.5,2
"10485","S Dakota St","Murray St",1,0,0,1
"10486","S Dakota St","N Dakota St",5,2,0.285714285714286,7
"10487","S Dakota St","NE Omaha",1,5,0.833333333333333,6
"10488","S Dakota St","New Mexico",0,1,1,1
"10489","S Dakota St","North Dakota",0,3,1,3
"10490","S Dakota St","Northern Iowa",1,0,0,1
"10491","S Dakota St","Oakland",1,1,0.5,2
"10492","S Dakota St","Oral Roberts",0,2,1,2
"10493","S Dakota St","San Diego",1,0,0,1
"10494","S Dakota St","Santa Barbara",1,0,0,1
"10495","S Dakota St","South Dakota",2,5,0.714285714285714,7
"10496","S Dakota St","Stanford",1,0,0,1
"10497","S Dakota St","St Louis",0,1,1,1
"10498","S Dakota St","Tennessee St",0,1,1,1
"10499","S Dakota St","Texas Tech",1,0,0,1
"10500","S Dakota St","Utah",1,0,0,1
"10501","S Dakota St","Utah St",0,1,1,1
"10502","S Dakota St","W Illinois",0,8,1,8
"10503","S Dakota St","Dakota St",0,1,1,1
"10504","S Dakota St","SW Minnesota",0,1,1,1
"10505","S Dakota St","Wayne St NE",0,2,1,2
"10506","S Dakota St","Chadron St",0,1,1,1
"10507","Seattle","Boise St",2,0,0,2
"10508","Seattle","Campbell",0,1,1,1
"10509","Seattle","Chicago St",2,3,0.6,5
"10510","Seattle","CS Bakersfield",4,1,0.2,5
"10511","Seattle","CS Fullerton",1,2,0.666666666666667,3
"10512","Seattle","CS Northridge",0,2,1,2
"10513","Seattle","CS Sacramento",0,1,1,1
"10514","Seattle","Denver",2,0,0,2
"10515","Seattle","E Washington",2,1,0.333333333333333,3
"10516","Seattle","Idaho",2,2,0.5,4
"10517","Seattle","Jackson St",1,0,0,1
"10518","Seattle","Louisiana Tech",2,0,0,2
"10519","Seattle","Minnesota",1,0,0,1
"10520","Seattle","Missouri KC",3,2,0.4,5
"10521","Seattle","Montana",1,0,0,1
"10522","Seattle","Montana St",0,1,1,1
"10523","Seattle","NE Omaha",1,1,0.5,2
"10524","Seattle","New Mexico St",7,1,0.125,8
"10525","Seattle","N Illinois",0,1,1,1
"10526","Seattle","Norfolk St",0,1,1,1
"10527","Seattle","San Jose St",1,2,0.666666666666667,3
"10528","Seattle","Santa Barbara",2,0,0,2
"10529","Seattle","Stanford",1,0,0,1
"10530","Seattle","Texas St",3,0,0,3
"10531","Seattle","TX Pan American",1,3,0.75,4
"10532","Seattle","UC Davis",0,2,1,2
"10533","Seattle","UC Riverside",0,1,1,1
"10534","Seattle","Utah St",2,0,0,2
"10535","Seattle","Utah Valley",2,2,0.5,4
"10536","Seattle","UT Arlington",1,1,0.5,2
"10537","Seattle","UT San Antonio",1,1,0.5,2
"10538","Seattle","Virginia",1,0,0,1
"10539","Seattle","Washington",3,0,0,3
"10540","Seattle","Evergreen St",0,1,1,1
"10541","Seattle","Grand Canyon",4,0,0,4
"10542","Seattle","Pac Lutheran",0,2,1,2
"10543","Seattle","Northwest WA",0,1,1,1
"10544","SE Louisiana","Arkansas",1,0,0,1
"10545","SE Louisiana","Cent Arkansas",2,3,0.6,5
"10546","SE Louisiana","Florida",1,0,0,1
"10547","SE Louisiana","Gonzaga",1,0,0,1
"10548","SE Louisiana","Houston Bap",0,2,1,2
"10549","SE Louisiana","Lamar",1,4,0.8,5
"10550","SE Louisiana","Louisiana Tech",1,0,0,1
"10551","SE Louisiana","LSU",1,0,0,1
"10552","SE Louisiana","Marquette",1,0,0,1
"10553","SE Louisiana","McNeese St",5,2,0.285714285714286,7
"10554","SE Louisiana","Mississippi St",1,0,0,1
"10555","SE Louisiana","Missouri",1,0,0,1
"10556","SE Louisiana","New Mexico St",1,0,0,1
"10557","SE Louisiana","New Orleans",4,0,0,4
"10558","SE Louisiana","Nicholls St",3,4,0.571428571428571,7
"10559","SE Louisiana","North Texas",2,0,0,2
"10560","SE Louisiana","Northwestern LA",5,0,0,5
"10561","SE Louisiana","Oklahoma",1,0,0,1
"10562","SE Louisiana","Oklahoma St",1,0,0,1
"10563","SE Louisiana","Oral Roberts",3,0,0,3
"10564","SE Louisiana","Rice",0,1,1,1
"10565","SE Louisiana","Sam Houston St",4,1,0.2,5
"10566","SE Louisiana","SE Missouri St",3,0,0,3
"10567","SE Louisiana","SF Austin",3,1,0.25,4
"10568","SE Louisiana","South Florida",1,0,0,1
"10569","SE Louisiana","TAM C. Christi",3,1,0.25,4
"10570","SE Louisiana","Tennessee Tech",1,1,0.5,2
"10571","SE Louisiana","TN Martin",0,1,1,1
"10572","SE Louisiana","Tulane",1,0,0,1
"10573","SE Louisiana","UCF",1,0,0,1
"10574","SE Louisiana","ULM",1,0,0,1
"10575","SE Louisiana","UTEP",1,0,0,1
"10576","SE Louisiana","W Illinois",1,1,0.5,2
"10577","SE Louisiana","Winthrop",1,1,0.5,2
"10578","SE Louisiana","Wisconsin",1,0,0,1
"10579","SE Louisiana","Abilene Chr",0,3,1,3
"10580","SE Louisiana","Champion Bap",0,1,1,1
"10581","SE Louisiana","Dillard",0,1,1,1
"10582","SE Louisiana","Incarnate Word",0,2,1,2
"10583","SE Louisiana","Spring Hill",0,1,1,1
"10584","SE Louisiana","Langston",0,1,1,1
"10585","SE Missouri St","Alabama A&M",0,1,1,1
"10586","SE Missouri St","Arkansas",1,0,0,1
"10587","SE Missouri St","Austin Peay",1,5,0.833333333333333,6
"10588","SE Missouri St","Ball St",2,0,0,2
"10589","SE Missouri St","Belmont",3,0,0,3
"10590","SE Missouri St","Bowling Green",1,0,0,1
"10591","SE Missouri St","Cent Arkansas",1,1,0.5,2
"10592","SE Missouri St","Chattanooga",0,1,1,1
"10593","SE Missouri St","Edwardsville",4,2,0.333333333333333,6
"10594","SE Missouri St","E Illinois",3,4,0.571428571428571,7
"10595","SE Missouri St","E Kentucky",4,0,0,4
"10596","SE Missouri St","IL Chicago",2,0,0,2
"10597","SE Missouri St","IUPUI",0,2,1,2
"10598","SE Missouri St","Jacksonville St",1,2,0.666666666666667,3
"10599","SE Missouri St","Kansas",1,0,0,1
"10600","SE Missouri St","Louisiana Tech",1,0,0,1
"10601","SE Missouri St","Loy Marymount",1,0,0,1
"10602","SE Missouri St","McNeese St",0,1,1,1
"10603","SE Missouri St","Memphis",1,0,0,1
"10604","SE Missouri St","Mississippi",1,0,0,1
"10605","SE Missouri St","Missouri",2,0,0,2
"10606","SE Missouri St","Missouri KC",0,2,1,2
"10607","SE Missouri St","Missouri St",2,0,0,2
"10608","SE Missouri St","Morehead St",4,0,0,4
"10609","SE Missouri St","Murray St",4,2,0.333333333333333,6
"10610","SE Missouri St","New Orleans",0,2,1,2
"10611","SE Missouri St","N Kentucky",0,1,1,1
"10612","SE Missouri St","San Diego",1,0,0,1
"10613","SE Missouri St","SE Louisiana",0,3,1,3
"10614","SE Missouri St","S Illinois",0,1,1,1
"10615","SE Missouri St","St Louis",1,0,0,1
"10616","SE Missouri St","Tennessee St",1,2,0.666666666666667,3
"10617","SE Missouri St","Tennessee Tech",0,3,1,3
"10618","SE Missouri St","Texas St",0,1,1,1
"10619","SE Missouri St","TN Martin",2,4,0.666666666666667,6
"10620","SE Missouri St","Troy",1,0,0,1
"10621","SE Missouri St","Tulane",0,1,1,1
"10622","SE Missouri St","Central Bap",0,1,1,1
"10623","SE Missouri St","Mid-Continent",0,1,1,1
"10624","SE Missouri St","Hannibal-Lagr",0,1,1,1
"10625","SE Missouri St","Harris-Stowe",0,1,1,1
"10626","Seton Hall","Butler",4,1,0.2,5
"10627","Seton Hall","Cincinnati",1,0,0,1
"10628","Seton Hall","Connecticut",1,0,0,1
"10629","Seton Hall","Creighton",2,2,0.5,4
"10630","Seton Hall","DePaul",3,2,0.4,5
"10631","Seton Hall","E Washington",0,1,1,1
"10632","Seton Hall","F Dickinson",1,0,0,1
"10633","Seton Hall","Gardner Webb",0,1,1,1
"10634","Seton Hall","Georgetown",3,2,0.4,5
"10635","Seton Hall","Georgia",1,0,0,1
"10636","Seton Hall","G Washington",0,1,1,1
"10637","Seton Hall","Illinois St",0,1,1,1
"10638","Seton Hall","Kent",0,1,1,1
"10639","Seton Hall","Lafayette",0,1,1,1
"10640","Seton Hall","Long Island",0,2,1,2
"10641","Seton Hall","Longwood",0,1,1,1
"10642","Seton Hall","Louisville",2,0,0,2
"10643","Seton Hall","LSU",1,0,0,1
"10644","Seton Hall","Maine",0,2,1,2
"10645","Seton Hall","Marquette",6,1,0.142857142857143,7
"10646","Seton Hall","Mercer",1,1,0.5,2
"10647","Seton Hall","Missouri KC",0,1,1,1
"10648","Seton Hall","Monmouth NJ",0,1,1,1
"10649","Seton Hall","Mt St Mary's",0,1,1,1
"10650","Seton Hall","NC A&T",0,1,1,1
"10651","Seton Hall","Nevada",0,1,1,1
"10652","Seton Hall","Niagara",0,1,1,1
"10653","Seton Hall","NJIT",0,2,1,2
"10654","Seton Hall","Norfolk St",0,1,1,1
"10655","Seton Hall","Notre Dame",1,0,0,1
"10656","Seton Hall","Oklahoma",1,0,0,1
"10657","Seton Hall","Pittsburgh",1,0,0,1
"10658","Seton Hall","Providence",6,1,0.142857142857143,7
"10659","Seton Hall","Rhode Island",0,1,1,1
"10660","Seton Hall","Rutgers",2,2,0.5,4
"10661","Seton Hall","South Florida",0,2,1,2
"10662","Seton Hall","St John's",4,1,0.2,5
"10663","Seton Hall","Stony Brook",0,1,1,1
"10664","Seton Hall","St Peter's",1,2,0.666666666666667,3
"10665","Seton Hall","Syracuse",1,0,0,1
"10666","Seton Hall","Villanova",3,3,0.5,6
"10667","Seton Hall","Virginia Tech",0,1,1,1
"10668","Seton Hall","Wake Forest",0,1,1,1
"10669","Seton Hall","Washington",1,0,0,1
"10670","Seton Hall","Wichita St",1,0,0,1
"10671","Seton Hall","Xavier",1,3,0.75,4
"10672","SF Austin","Austin Peay",0,1,1,1
"10673","SF Austin","Baylor",1,0,0,1
"10674","SF Austin","Cent Arkansas",0,5,1,5
"10675","SF Austin","CS Northridge",0,2,1,2
"10676","SF Austin","ETSU",1,0,0,1
"10677","SF Austin","Florida Intl",0,1,1,1
"10678","SF Austin","Grambling",0,1,1,1
"10679","SF Austin","High Point",0,1,1,1
"10680","SF Austin","Houston Bap",0,3,1,3
"10681","SF Austin","James Madison",0,1,1,1
"10682","SF Austin","Lamar",0,6,1,6
"10683","SF Austin","Long Beach St",0,2,1,2
"10684","SF Austin","Marshall",0,1,1,1
"10685","SF Austin","McNeese St",0,4,1,4
"10686","SF Austin","Memphis",0,1,1,1
"10687","SF Austin","New Orleans",0,2,1,2
"10688","SF Austin","Nicholls St",0,4,1,4
"10689","SF Austin","Northern Iowa",1,0,0,1
"10690","SF Austin","North Texas",0,2,1,2
"10691","SF Austin","Northwestern LA",1,7,0.875,8
"10692","SF Austin","Oklahoma",0,1,1,1
"10693","SF Austin","Oral Roberts",0,4,1,4
"10694","SF Austin","Prairie View",0,1,1,1
"10695","SF Austin","Samford",0,1,1,1
"10696","SF Austin","Sam Houston St",0,8,1,8
"10697","SF Austin","San Diego",0,1,1,1
"10698","SF Austin","SE Louisiana",1,3,0.75,4
"10699","SF Austin","TAM C. Christi",1,4,0.8,5
"10700","SF Austin","Texas",1,0,0,1
"10701","SF Austin","Texas A&M",1,0,0,1
"10702","SF Austin","Texas St",0,2,1,2
"10703","SF Austin","Towson",0,1,1,1
"10704","SF Austin","Tulsa",0,1,1,1
"10705","SF Austin","UNC Wilmington",0,1,1,1
"10706","SF Austin","Xavier",1,0,0,1
"10707","SF Austin","Abilene Chr",0,2,1,2
"10708","SF Austin","Elmhurst",0,1,1,1
"10709","SF Austin","Incarnate Word",0,3,1,3
"10710","SF Austin","Mississippi Col",0,1,1,1
"10711","SF Austin","UT Tyler",0,1,1,1
"10712","SF Austin","Arkansas Tech",0,1,1,1
"10713","SF Austin","Ouachita",0,1,1,1
"10714","Siena","Albany NY",3,0,0,3
"10715","Siena","Bucknell",0,1,1,1
"10716","Siena","Canisius",6,1,0.142857142857143,7
"10717","Siena","Cornell",1,1,0.5,2
"10718","Siena","CS Northridge",1,0,0,1
"10719","Siena","Fairfield",3,3,0.5,6
"10720","Siena","Fordham",2,1,0.333333333333333,3
"10721","Siena","Hofstra",0,1,1,1
"10722","Siena","Iona",7,0,0,7
"10723","Siena","La Salle",2,0,0,2
"10724","Siena","Loyola MD",2,1,0.333333333333333,3
"10725","Siena","Maine",1,0,0,1
"10726","Siena","Manhattan",4,2,0.333333333333333,6
"10727","Siena","Marist",2,4,0.666666666666667,6
"10728","Siena","Massachusetts",2,0,0,2
"10729","Siena","Memphis",1,0,0,1
"10730","Siena","Monmouth NJ",3,1,0.25,4
"10731","Siena","Navy",0,1,1,1
"10732","Siena","Niagara",2,5,0.714285714285714,7
"10733","Siena","N Kentucky",0,1,1,1
"10734","Siena","Purdue",2,0,0,2
"10735","Siena","Quinnipiac",2,2,0.5,4
"10736","Siena","Radford",1,1,0.5,2
"10737","Siena","Rider",3,3,0.5,6
"10738","Siena","San Diego",1,0,0,1
"10739","Siena","St Bonaventure",1,2,0.666666666666667,3
"10740","Siena","St Joseph's PA",1,0,0,1
"10741","Siena","St Peter's",4,2,0.333333333333333,6
"10742","Siena","Vermont",3,0,0,3
"10743","S Illinois","Austin Peay",1,1,0.5,2
"10744","S Illinois","Ball St",0,1,1,1
"10745","S Illinois","Bradley",4,2,0.333333333333333,6
"10746","S Illinois","Chicago St",1,1,0.5,2
"10747","S Illinois","Creighton",2,0,0,2
"10748","S Illinois","Drake",3,3,0.5,6
"10749","S Illinois","Edwardsville",0,3,1,3
"10750","S Illinois","Evansville",4,2,0.333333333333333,6
"10751","S Illinois","Fresno St",0,1,1,1
"10752","S Illinois","IL Chicago",0,1,1,1
"10753","S Illinois","Illinois St",4,2,0.333333333333333,6
"10754","S Illinois","Indiana St",5,2,0.285714285714286,7
"10755","S Illinois","Kent",1,0,0,1
"10756","S Illinois","Loyola-Chicago",1,3,0.75,4
"10757","S Illinois","Miami OH",1,1,0.5,2
"10758","S Illinois","Missouri",1,0,0,1
"10759","S Illinois","Missouri St",4,3,0.428571428571429,7
"10760","S Illinois","Murray St",2,0,0,2
"10761","S Illinois","New Orleans",1,2,0.666666666666667,3
"10762","S Illinois","Nicholls St",0,1,1,1
"10763","S Illinois","Northern Iowa",4,3,0.428571428571429,7
"10764","S Illinois","San Diego",1,0,0,1
"10765","S Illinois","SE Missouri St",1,0,0,1
"10766","S Illinois","St Bonaventure",1,0,0,1
"10767","S Illinois","Stetson",0,1,1,1
"10768","S Illinois","St Louis",3,0,0,3
"10769","S Illinois","Tennessee St",0,2,1,2
"10770","S Illinois","UC Davis",1,0,0,1
"10771","S Illinois","Utah St",1,0,0,1
"10772","S Illinois","Wichita St",6,1,0.142857142857143,7
"10773","S Illinois","WI Green Bay",0,1,1,1
"10774","S Illinois","W Kentucky",2,0,0,2
"10775","S Illinois","Yale",1,0,0,1
"10776","S Illinois","Missouri S&T",0,1,1,1
"10777","S Illinois","Olivet Naz",0,1,1,1
"10778","SMU","Alcorn St",0,1,1,1
"10779","SMU","Arkansas",2,0,0,2
"10780","SMU","Ark Little Rock",1,0,0,1
"10781","SMU","Ark Pine Bluff",0,1,1,1
"10782","SMU","Cincinnati",3,1,0.25,4
"10783","SMU","Connecticut",1,4,0.8,5
"10784","SMU","East Carolina",1,2,0.666666666666667,3
"10785","SMU","E Washington",0,1,1,1
"10786","SMU","Furman",0,1,1,1
"10787","SMU","Gonzaga",1,0,0,1
"10788","SMU","Hofstra",0,2,1,2
"10789","SMU","Houston",3,4,0.571428571428571,7
"10790","SMU","IL Chicago",0,2,1,2
"10791","SMU","Indiana",1,0,0,1
"10792","SMU","Lamar",0,1,1,1
"10793","SMU","Louisville",2,0,0,2
"10794","SMU","Loy Marymount",0,1,1,1
"10795","SMU","Marshall",0,1,1,1
"10796","SMU","McNeese St",0,1,1,1
"10797","SMU","Memphis",2,3,0.6,5
"10798","SMU","Michigan",0,1,1,1
"10799","SMU","Missouri St",0,1,1,1
"10800","SMU","Monmouth NJ",0,1,1,1
"10801","SMU","Rhode Island",1,1,0.5,2
"10802","SMU","Rice",0,2,1,2
"10803","SMU","Rider",0,1,1,1
"10804","SMU","Rutgers",0,2,1,2
"10805","SMU","Sam Houston St",0,1,1,1
"10806","SMU","Santa Barbara",0,1,1,1
"10807","SMU","Southern Miss",1,0,0,1
"10808","SMU","South Florida",1,3,0.75,4
"10809","SMU","TCU",0,2,1,2
"10810","SMU","Temple",1,4,0.8,5
"10811","SMU","Texas A&M",0,1,1,1
"10812","SMU","Texas St",0,2,1,2
"10813","SMU","Tulane",1,2,0.666666666666667,3
"10814","SMU","Tulsa",1,3,0.75,4
"10815","SMU","TX Pan American",0,1,1,1
"10816","SMU","TX Southern",0,1,1,1
"10817","SMU","UAB",1,0,0,1
"10818","SMU","UCF",1,4,0.8,5
"10819","SMU","Utah",1,1,0.5,2
"10820","SMU","UTEP",2,0,0,2
"10821","SMU","Virginia",1,0,0,1
"10822","SMU","Wagner",1,0,0,1
"10823","SMU","Wyoming",1,2,0.666666666666667,3
"10824","SMU","Midwest TX St",0,1,1,1
"10825","South Alabama","Appalachian St",1,1,0.5,2
"10826","South Alabama","Arkansas",1,0,0,1
"10827","South Alabama","Arkansas St",5,1,0.166666666666667,6
"10828","South Alabama","Ark Little Rock",2,5,0.714285714285714,7
"10829","South Alabama","Detroit",1,1,0.5,2
"10830","South Alabama","FL Atlantic",0,2,1,2
"10831","South Alabama","Florida Intl",0,2,1,2
"10832","South Alabama","Florida St",0,1,1,1
"10833","South Alabama","Ga Southern",2,0,0,2
"10834","South Alabama","Georgia St",5,0,0,5
"10835","South Alabama","Gonzaga",1,0,0,1
"10836","South Alabama","Houston Bap",0,1,1,1
"10837","South Alabama","Howard",1,0,0,1
"10838","South Alabama","IUPUI",1,0,0,1
"10839","South Alabama","Miami FL",1,0,0,1
"10840","South Alabama","Middle Tenn St",3,0,0,3
"10841","South Alabama","Monmouth NJ",1,0,0,1
"10842","South Alabama","New Mexico St",2,0,0,2
"10843","South Alabama","NJIT",1,0,0,1
"10844","South Alabama","North Texas",1,1,0.5,2
"10845","South Alabama","Pepperdine",1,0,0,1
"10846","South Alabama","Rice",1,0,0,1
"10847","South Alabama","Richmond",1,0,0,1
"10848","South Alabama","Southern Miss",2,0,0,2
"10849","South Alabama","TAM C. Christi",0,1,1,1
"10850","South Alabama","Tennessee St",1,0,0,1
"10851","South Alabama","Texas",1,0,0,1
"10852","South Alabama","Texas St",3,1,0.25,4
"10853","South Alabama","Troy",1,5,0.833333333333333,6
"10854","South Alabama","UAB",1,0,0,1
"10855","South Alabama","ULL",1,5,0.833333333333333,6
"10856","South Alabama","ULM",5,2,0.285714285714286,7
"10857","South Alabama","UT Arlington",2,2,0.5,4
"10858","South Alabama","W Kentucky",2,2,0.5,4
"10859","South Alabama","Wright St",0,1,1,1
"10860","South Alabama","Carroll MT",0,1,1,1
"10861","South Alabama","Dillard",0,1,1,1
"10862","South Alabama","Spring Hill",0,2,1,2
"10863","South Alabama","Wm Carey",0,1,1,1
"10864","South Alabama","MTSU",1,0,0,1
"10865","South Carolina","Akron",1,2,0.666666666666667,3
"10866","South Carolina","Alabama",2,2,0.5,4
"10867","South Carolina","Appalachian St",0,1,1,1
"10868","South Carolina","Arkansas",3,2,0.4,5
"10869","South Carolina","Ark Little Rock",0,1,1,1
"10870","South Carolina","Auburn",4,1,0.2,5
"10871","South Carolina","Baylor",2,0,0,2
"10872","South Carolina","Boise St",1,0,0,1
"10873","South Carolina","Charlotte",1,0,0,1
"10874","South Carolina","Clemson",2,1,0.333333333333333,3
"10875","South Carolina","Cornell",0,1,1,1
"10876","South Carolina","Elon",1,0,0,1
"10877","South Carolina","Florida",4,0,0,4
"10878","South Carolina","Florida Intl",0,1,1,1
"10879","South Carolina","Georgia",5,2,0.285714285714286,7
"10880","South Carolina","Iowa St",0,1,1,1
"10881","South Carolina","Jacksonville",0,1,1,1
"10882","South Carolina","Kentucky",3,1,0.25,4
"10883","South Carolina","Longwood",0,1,1,1
"10884","South Carolina","LSU",3,1,0.25,4
"10885","South Carolina","Manhattan",1,1,0.5,2
"10886","South Carolina","Marshall",0,2,1,2
"10887","South Carolina","Mississippi",3,2,0.4,5
"10888","South Carolina","Mississippi St",1,3,0.75,4
"10889","South Carolina","Missouri",3,2,0.4,5
"10890","South Carolina","Missouri St",0,1,1,1
"10891","South Carolina","Morgan St",0,1,1,1
"10892","South Carolina","NC A&T",0,1,1,1
"10893","South Carolina","North Florida",0,1,1,1
"10894","South Carolina","Oklahoma St",1,1,0.5,2
"10895","South Carolina","Presbyterian",0,1,1,1
"10896","South Carolina","Rider",0,1,1,1
"10897","South Carolina","S Carolina St",0,2,1,2
"10898","South Carolina","SC Upstate",1,0,0,1
"10899","South Carolina","St John's",1,0,0,1
"10900","South Carolina","St Mary's CA",0,1,1,1
"10901","South Carolina","Tennessee",4,1,0.2,5
"10902","South Carolina","Texas A&M",3,1,0.25,4
"10903","South Carolina","UNC Asheville",0,1,1,1
"10904","South Carolina","Vanderbilt",3,1,0.25,4
"10905","South Carolina","WI Milwaukee",0,1,1,1
"10906","South Carolina","Coker",0,1,1,1
"10907","South Dakota","Air Force",1,0,0,1
"10908","South Dakota","Ball St",2,0,0,2
"10909","South Dakota","Canisius",1,0,0,1
"10910","South Dakota","Creighton",1,0,0,1
"10911","South Dakota","CS Bakersfield",0,1,1,1
"10912","South Dakota","CS Northridge",0,2,1,2
"10913","South Dakota","Denver",3,2,0.4,5
"10914","South Dakota","Fairfield",1,0,0,1
"10915","South Dakota","Gonzaga",1,0,0,1
"10916","South Dakota","Iowa",1,0,0,1
"10917","South Dakota","IPFW",4,3,0.428571428571429,7
"10918","South Dakota","IUPUI",1,5,0.833333333333333,6
"10919","South Dakota","Kansas St",2,0,0,2
"10920","South Dakota","Missouri KC",2,0,0,2
"10921","South Dakota","Montana",0,1,1,1
"10922","South Dakota","Montana St",0,2,1,2
"10923","South Dakota","Morehead St",1,1,0.5,2
"10924","South Dakota","NC Central",0,1,1,1
"10925","South Dakota","N Dakota St",5,1,0.166666666666667,6
"10926","South Dakota","NE Omaha",3,3,0.5,6
"10927","South Dakota","Oakland",1,1,0.5,2
"10928","South Dakota","Oral Roberts",1,1,0.5,2
"10929","South Dakota","Sam Houston St",1,0,0,1
"10930","South Dakota","S Dakota St",5,2,0.285714285714286,7
"10931","South Dakota","Southern Univ",1,0,0,1
"10932","South Dakota","Stanford",1,0,0,1
"10933","South Dakota","St Bonaventure",1,0,0,1
"10934","South Dakota","Texas St",0,1,1,1
"10935","South Dakota","UNLV",1,0,0,1
"10936","South Dakota","Utah Valley",1,1,0.5,2
"10937","South Dakota","WI Green Bay",2,0,0,2
"10938","South Dakota","W Illinois",3,3,0.5,6
"10939","South Dakota","WI Milwaukee",0,1,1,1
"10940","South Dakota","Wofford",1,0,0,1
"10941","South Dakota","Wyoming",3,0,0,3
"10942","South Dakota","Youngstown St",2,0,0,2
"10943","South Dakota","Graceland",0,1,1,1
"10944","South Dakota","Iowa Wesleyan",0,1,1,1
"10945","South Dakota","Peru St",0,1,1,1
"10946","South Dakota","Wayne St NE",0,1,1,1
"10947","South Dakota","Avila",0,1,1,1
"10948","Southern Miss","Alabama",1,0,0,1
"10949","Southern Miss","Arizona",1,0,0,1
"10950","Southern Miss","Ark Little Rock",0,1,1,1
"10951","Southern Miss","Charlotte",1,1,0.5,2
"10952","Southern Miss","Coppin St",0,1,1,1
"10953","Southern Miss","Denver",0,1,1,1
"10954","Southern Miss","DePaul",0,1,1,1
"10955","Southern Miss","Drexel",1,1,0.5,2
"10956","Southern Miss","East Carolina",0,3,1,3
"10957","Southern Miss","FL Atlantic",0,2,1,2
"10958","Southern Miss","Florida Intl",1,1,0.5,2
"10959","Southern Miss","Georgia",0,1,1,1
"10960","Southern Miss","Georgia St",1,2,0.666666666666667,3
"10961","Southern Miss","Grambling",0,1,1,1
"10962","Southern Miss","Houston",0,1,1,1
"10963","Southern Miss","Houston Bap",0,1,1,1
"10964","Southern Miss","Jackson St",1,1,0.5,2
"10965","Southern Miss","Liberty",0,1,1,1
"10966","Southern Miss","Louisiana Tech",4,1,0.2,5
"10967","Southern Miss","Louisville",1,0,0,1
"10968","Southern Miss","LSU",1,0,0,1
"10969","Southern Miss","Marshall",3,2,0.4,5
"10970","Southern Miss","Memphis",2,0,0,2
"10971","Southern Miss","Middle Tenn St",1,0,0,1
"10972","Southern Miss","Morehead St",0,2,1,2
"10973","Southern Miss","N Dakota St",0,2,1,2
"10974","Southern Miss","New Mexico St",1,0,0,1
"10975","Southern Miss","North Texas",0,2,1,2
"10976","Southern Miss","Old Dominion",1,1,0.5,2
"10977","Southern Miss","Rhode Island",1,1,0.5,2
"10978","Southern Miss","Rice",1,2,0.666666666666667,3
"10979","Southern Miss","Sam Houston St",0,1,1,1
"10980","Southern Miss","SMU",0,1,1,1
"10981","Southern Miss","South Alabama",0,2,1,2
"10982","Southern Miss","Troy",0,1,1,1
"10983","Southern Miss","Tulane",0,3,1,3
"10984","Southern Miss","Tulsa",1,1,0.5,2
"10985","Southern Miss","UAB",3,2,0.4,5
"10986","Southern Miss","UCF",1,1,0.5,2
"10987","Southern Miss","UC Irvine",0,1,1,1
"10988","Southern Miss","UTEP",1,4,0.8,5
"10989","Southern Miss","UT San Antonio",1,2,0.666666666666667,3
"10990","Southern Miss","Wichita St",1,0,0,1
"10991","Southern Miss","W Kentucky",2,1,0.333333333333333,3
"10992","Southern Miss","Spring Hill",0,1,1,1
"10993","Southern Miss","St Catharine",0,1,1,1
"10994","Southern Miss","Wm Carey",0,2,1,2
"10995","Southern Miss","MTSU",2,0,0,2
"10996","Southern Univ","Alabama A&M",0,7,1,7
"10997","Southern Univ","Alabama St",2,5,0.714285714285714,7
"10998","Southern Univ","Alcorn St",1,5,0.833333333333333,6
"10999","Southern Univ","Arizona",1,0,0,1
"11000","Southern Univ","Ark Little Rock",1,0,0,1
"11001","Southern Univ","Ark Pine Bluff",2,4,0.666666666666667,6
"11002","Southern Univ","Baylor",2,0,0,2
"11003","Southern Univ","Denver",1,0,0,1
"11004","Southern Univ","E Illinois",1,0,0,1
"11005","Southern Univ","Florida",1,0,0,1
"11006","Southern Univ","Grambling",0,6,1,6
"11007","Southern Univ","Hawaii",1,0,0,1
"11008","Southern Univ","Iowa St",2,0,0,2
"11009","Southern Univ","Jackson St",1,5,0.833333333333333,6
"11010","Southern Univ","Louisiana Tech",2,0,0,2
"11011","Southern Univ","Marquette",1,0,0,1
"11012","Southern Univ","Middle Tenn St",1,0,0,1
"11013","Southern Univ","Minnesota",1,0,0,1
"11014","Southern Univ","Mississippi",1,0,0,1
"11015","Southern Univ","MS Valley St",1,5,0.833333333333333,6
"11016","Southern Univ","NC Central",1,0,0,1
"11017","Southern Univ","Nebraska",1,0,0,1
"11018","Southern Univ","Northern Arizona",1,0,0,1
"11019","Southern Univ","North Florida",0,1,1,1
"11020","Southern Univ","Prairie View",1,6,0.857142857142857,7
"11021","Southern Univ","South Dakota",0,1,1,1
"11022","Southern Univ","TCU",1,0,0,1
"11023","Southern Univ","Texas A&M",0,1,1,1
"11024","Southern Univ","Tulane",3,0,0,3
"11025","Southern Univ","TX Southern",5,2,0.285714285714286,7
"11026","Southern Univ","ULM",0,1,1,1
"11027","Southern Univ","Wyoming",2,0,0,2
"11028","Southern Univ","Blue Mtn",0,1,1,1
"11029","Southern Univ","Champion Bap",0,2,1,2
"11030","Southern Univ","Dillard",0,2,1,2
"11031","Southern Univ","LSU-Alexandria",0,1,1,1
"11032","Southern Univ","MTSU",1,0,0,1
"11033","Southern Utah","Ark Pine Bluff",1,0,0,1
"11034","Southern Utah","Boise St",1,0,0,1
"11035","Southern Utah","California",1,0,0,1
"11036","Southern Utah","CS Fullerton",1,0,0,1
"11037","Southern Utah","CS Northridge",1,1,0.5,2
"11038","Southern Utah","CS Sacramento",4,2,0.333333333333333,6
"11039","Southern Utah","Denver",1,0,0,1
"11040","Southern Utah","E Kentucky",1,0,0,1
"11041","Southern Utah","E Washington",4,1,0.2,5
"11042","Southern Utah","Gonzaga",1,0,0,1
"11043","Southern Utah","Idaho",0,1,1,1
"11044","Southern Utah","Idaho St",3,3,0.5,6
"11045","Southern Utah","Kansas St",1,0,0,1
"11046","Southern Utah","Loyola-Chicago",1,0,0,1
"11047","Southern Utah","Miami OH",1,0,0,1
"11048","Southern Utah","Montana",5,0,0,5
"11049","Southern Utah","Montana St",5,0,0,5
"11050","Southern Utah","N Colorado",5,1,0.166666666666667,6
"11051","Southern Utah","Nevada",1,0,0,1
"11052","Southern Utah","North Dakota",3,3,0.5,6
"11053","Southern Utah","Northern Arizona",4,2,0.333333333333333,6
"11054","Southern Utah","Portland",1,0,0,1
"11055","Southern Utah","Portland St",5,1,0.166666666666667,6
"11056","Southern Utah","San Diego",2,0,0,2
"11057","Southern Utah","San Diego St",1,0,0,1
"11058","Southern Utah","S Carolina St",0,1,1,1
"11059","Southern Utah","TCU",1,0,0,1
"11060","Southern Utah","UC Riverside",1,0,0,1
"11061","Southern Utah","UNLV",2,0,0,2
"11062","Southern Utah","Utah St",1,0,0,1
"11063","Southern Utah","Utah Valley",1,0,0,1
"11064","Southern Utah","UT San Antonio",0,1,1,1
"11065","Southern Utah","Weber St",4,2,0.333333333333333,6
"11066","Southern Utah","WI Green Bay",1,0,0,1
"11067","Southern Utah","Arizona Chr",0,1,1,1
"11068","Southern Utah","St Katherine",0,1,1,1
"11069","South Florida","Alabama",1,1,0.5,2
"11070","South Florida","Bethune-Cookman",0,1,1,1
"11071","South Florida","Bowling Green",1,2,0.666666666666667,3
"11072","South Florida","Bradley",0,2,1,2
"11073","South Florida","Cincinnati",4,0,0,4
"11074","South Florida","Connecticut",6,1,0.142857142857143,7
"11075","South Florida","DePaul",0,1,1,1
"11076","South Florida","Detroit",2,0,0,2
"11077","South Florida","East Carolina",1,1,0.5,2
"11078","South Florida","FL Gulf Coast",0,1,1,1
"11079","South Florida","Florida A&M",0,1,1,1
"11080","South Florida","Florida St",1,0,0,1
"11081","South Florida","Ga Southern",1,0,0,1
"11082","South Florida","George Mason",0,2,1,2
"11083","South Florida","Georgetown",0,1,1,1
"11084","South Florida","Georgia",0,1,1,1
"11085","South Florida","Hofstra",0,1,1,1
"11086","South Florida","Houston",3,1,0.25,4
"11087","South Florida","Jackson St",0,1,1,1
"11088","South Florida","Jacksonville",0,1,1,1
"11089","South Florida","Louisville",4,0,0,4
"11090","South Florida","Loyola-Chicago",0,1,1,1
"11091","South Florida","Marquette",2,0,0,2
"11092","South Florida","MD E Shore",0,1,1,1
"11093","South Florida","Memphis",3,0,0,3
"11094","South Florida","Mississippi St",1,0,0,1
"11095","South Florida","NC State",1,0,0,1
"11096","South Florida","Notre Dame",1,0,0,1
"11097","South Florida","Oklahoma St",2,0,0,2
"11098","South Florida","Pittsburgh",1,0,0,1
"11099","South Florida","Providence",1,0,0,1
"11100","South Florida","Rutgers",4,0,0,4
"11101","South Florida","Santa Clara",1,0,0,1
"11102","South Florida","SE Louisiana",0,1,1,1
"11103","South Florida","Seton Hall",2,0,0,2
"11104","South Florida","SMU",3,1,0.25,4
"11105","South Florida","Stetson",0,2,1,2
"11106","South Florida","St John's",1,0,0,1
"11107","South Florida","Syracuse",1,0,0,1
"11108","South Florida","Temple",3,1,0.25,4
"11109","South Florida","Tennessee Tech",0,1,1,1
"11110","South Florida","Tulane",2,0,0,2
"11111","South Florida","Tulsa",2,0,0,2
"11112","South Florida","UAB",0,1,1,1
"11113","South Florida","UCF",3,3,0.5,6
"11114","South Florida","Villanova",2,0,0,2
"11115","South Florida","W Michigan",1,0,0,1
"11116","South Florida","Youngstown St",0,1,1,1
"11117","South Florida","Flagler",0,1,1,1
"11118","Stanford","Alcorn St",0,1,1,1
"11119","Stanford","Arizona",5,0,0,5
"11120","Stanford","Arizona St",2,4,0.666666666666667,6
"11121","Stanford","Ark Pine Bluff",0,1,1,1
"11122","Stanford","Belmont",1,0,0,1
"11123","Stanford","Bucknell",0,1,1,1
"11124","Stanford","BYU",2,0,0,2
"11125","Stanford","California",1,5,0.833333333333333,6
"11126","Stanford","Cal Poly SLO",0,1,1,1
"11127","Stanford","Colorado",4,0,0,4
"11128","Stanford","Connecticut",0,2,1,2
"11129","Stanford","CS Fullerton",0,1,1,1
"11130","Stanford","Delaware",0,1,1,1
"11131","Stanford","Denver",0,3,1,3
"11132","Stanford","DePaul",1,0,0,1
"11133","Stanford","Duke",1,0,0,1
"11134","Stanford","Houston",0,1,1,1
"11135","Stanford","Lafayette",0,1,1,1
"11136","Stanford","Loy Marymount",0,1,1,1
"11137","Stanford","Michigan",1,0,0,1
"11138","Stanford","Minnesota",1,0,0,1
"11139","Stanford","Missouri",1,0,0,1
"11140","Stanford","NC State",1,0,0,1
"11141","Stanford","Northern Iowa",0,1,1,1
"11142","Stanford","Northwestern",0,2,1,2
"11143","Stanford","Oregon",2,2,0.5,4
"11144","Stanford","Oregon St",1,3,0.75,4
"11145","Stanford","Pittsburgh",1,0,0,1
"11146","Stanford","San Francisco",0,1,1,1
"11147","Stanford","S Dakota St",0,1,1,1
"11148","Stanford","Seattle",0,1,1,1
"11149","Stanford","South Dakota",0,1,1,1
"11150","Stanford","Texas",0,1,1,1
"11151","Stanford","TX Southern",0,1,1,1
"11152","Stanford","UC Davis",0,2,1,2
"11153","Stanford","UCLA",6,1,0.142857142857143,7
"11154","Stanford","UNLV",0,1,1,1
"11155","Stanford","USC",2,4,0.666666666666667,6
"11156","Stanford","Utah",2,3,0.6,5
"11157","Stanford","Washington",2,4,0.666666666666667,6
"11158","Stanford","Washington St",1,5,0.833333333333333,6
"11159","Stanford","Wofford",0,1,1,1
"11160","St Bonaventure","Arkansas St",1,0,0,1
"11161","St Bonaventure","Bethune-Cookman",0,1,1,1
"11162","St Bonaventure","Binghamton",0,1,1,1
"11163","St Bonaventure","Buffalo",1,2,0.666666666666667,3
"11164","St Bonaventure","Butler",1,0,0,1
"11165","St Bonaventure","Canisius",1,2,0.666666666666667,3
"11166","St Bonaventure","Charlotte",0,1,1,1
"11167","St Bonaventure","Citadel",0,1,1,1
"11168","St Bonaventure","Cleveland St",0,1,1,1
"11169","St Bonaventure","Colorado St",1,0,0,1
"11170","St Bonaventure","Cornell",0,2,1,2
"11171","St Bonaventure","Dartmouth",0,1,1,1
"11172","St Bonaventure","Davidson",0,1,1,1
"11173","St Bonaventure","Dayton",5,0,0,5
"11174","St Bonaventure","Delaware",1,1,0.5,2
"11175","St Bonaventure","Duquesne",1,5,0.833333333333333,6
"11176","St Bonaventure","Fordham",1,2,0.666666666666667,3
"11177","St Bonaventure","George Mason",0,2,1,2
"11178","St Bonaventure","G Washington",3,0,0,3
"11179","St Bonaventure","Iona",1,1,0.5,2
"11180","St Bonaventure","Jackson St",0,1,1,1
"11181","St Bonaventure","La Salle",3,2,0.4,5
"11182","St Bonaventure","Louisiana Tech",1,0,0,1
"11183","St Bonaventure","Massachusetts",2,3,0.6,5
"11184","St Bonaventure","MD E Shore",1,0,0,1
"11185","St Bonaventure","NC State",1,0,0,1
"11186","St Bonaventure","Niagara",0,3,1,3
"11187","St Bonaventure","Ohio",1,1,0.5,2
"11188","St Bonaventure","Pittsburgh",1,0,0,1
"11189","St Bonaventure","Rhode Island",2,1,0.333333333333333,3
"11190","St Bonaventure","Richmond",4,1,0.2,5
"11191","St Bonaventure","Siena",2,1,0.333333333333333,3
"11192","St Bonaventure","S Illinois",0,1,1,1
"11193","St Bonaventure","South Dakota",0,1,1,1
"11194","St Bonaventure","St Joseph's PA",2,4,0.666666666666667,6
"11195","St Bonaventure","St Louis",2,2,0.5,4
"11196","St Bonaventure","Temple",0,1,1,1
"11197","St Bonaventure","VA Commonwealth",2,1,0.333333333333333,3
"11198","St Bonaventure","Wagner",0,1,1,1
"11199","St Bonaventure","Wake Forest",1,0,0,1
"11200","St Bonaventure","Xavier",1,0,0,1
"11201","St Bonaventure","Abilene Chr",0,1,1,1
"11202","St Bonaventure","MA Lowell",0,1,1,1
"11203","Stetson","Bethune-Cookman",1,2,0.666666666666667,3
"11204","Stetson","Clemson",1,0,0,1
"11205","Stetson","Davidson",2,0,0,2
"11206","Stetson","ETSU",2,2,0.5,4
"11207","Stetson","FL Atlantic",2,2,0.5,4
"11208","Stetson","FL Gulf Coast",6,1,0.142857142857143,7
"11209","Stetson","Florida A&M",1,3,0.75,4
"11210","Stetson","Florida Intl",3,0,0,3
"11211","Stetson","Florida St",1,0,0,1
"11212","Stetson","Ga Southern",1,0,0,1
"11213","Stetson","IPFW",1,0,0,1
"11214","Stetson","Jacksonville",3,3,0.5,6
"11215","Stetson","Kennesaw",3,3,0.5,6
"11216","Stetson","Lipscomb",2,4,0.666666666666667,6
"11217","Stetson","Mercer",4,0,0,4
"11218","Stetson","Miami FL",1,0,0,1
"11219","Stetson","N Colorado",1,0,0,1
"11220","Stetson","New Mexico St",1,0,0,1
"11221","Stetson","N Kentucky",3,3,0.5,6
"11222","Stetson","North Florida",7,0,0,7
"11223","Stetson","Notre Dame",1,0,0,1
"11224","Stetson","Richmond",1,0,0,1
"11225","Stetson","SC Upstate",3,3,0.5,6
"11226","Stetson","S Illinois",1,0,0,1
"11227","Stetson","South Florida",2,0,0,2
"11228","Stetson","UCF",3,0,0,3
"11229","Stetson","UNC Greensboro",1,0,0,1
"11230","Stetson","VA Commonwealth",1,0,0,1
"11231","Stetson","Wagner",1,0,0,1
"11232","Stetson","Wyoming",1,0,0,1
"11233","Stetson","Edward Waters",0,1,1,1
"11234","Stetson","Florida Tech",0,1,1,1
"11235","Stetson","Palm Beach Atl",0,1,1,1
"11236","St Francis NY","Albany NY",1,0,0,1
"11237","St Francis NY","Army",3,0,0,3
"11238","St Francis NY","Boston College",1,0,0,1
"11239","St Francis NY","Brown",0,1,1,1
"11240","St Francis NY","Bryant",3,2,0.4,5
"11241","St Francis NY","Canisius",0,1,1,1
"11242","St Francis NY","Central Conn",2,3,0.6,5
"11243","St Francis NY","Coastal Car",1,0,0,1
"11244","St Francis NY","Colgate",0,1,1,1
"11245","St Francis NY","Columbia",1,1,0.5,2
"11246","St Francis NY","Dayton",1,0,0,1
"11247","St Francis NY","Delaware St",1,1,0.5,2
"11248","St Francis NY","F Dickinson",1,5,0.833333333333333,6
"11249","St Francis NY","FL Atlantic",0,2,1,2
"11250","St Francis NY","Georgetown",1,0,0,1
"11251","St Francis NY","Illinois",1,0,0,1
"11252","St Francis NY","Lafayette",0,2,1,2
"11253","St Francis NY","La Salle",1,0,0,1
"11254","St Francis NY","Liberty",0,1,1,1
"11255","St Francis NY","Long Island",3,4,0.571428571428571,7
"11256","St Francis NY","Miami FL",0,1,1,1
"11257","St Francis NY","Monmouth NJ",3,1,0.25,4
"11258","St Francis NY","Mt St Mary's",4,2,0.333333333333333,6
"11259","St Francis NY","NJIT",1,2,0.666666666666667,3
"11260","St Francis NY","Norfolk St",2,0,0,2
"11261","St Francis NY","Oakland",0,1,1,1
"11262","St Francis NY","Quinnipiac",1,1,0.5,2
"11263","St Francis NY","Robert Morris",5,2,0.285714285714286,7
"11264","St Francis NY","Rutgers",1,0,0,1
"11265","St Francis NY","Sacred Heart",1,5,0.833333333333333,6
"11266","St Francis NY","St Francis PA",1,5,0.833333333333333,6
"11267","St Francis NY","St John's",1,0,0,1
"11268","St Francis NY","Stony Brook",1,1,0.5,2
"11269","St Francis NY","Syracuse",1,0,0,1
"11270","St Francis NY","Tennessee St",0,1,1,1
"11271","St Francis NY","Wagner",0,5,1,5
"11272","St Francis NY","Mt St Vincent",0,2,1,2
"11273","St Francis PA","Albany NY",0,1,1,1
"11274","St Francis PA","American Univ",3,0,0,3
"11275","St Francis PA","Bryant",4,2,0.333333333333333,6
"11276","St Francis PA","Bucknell",2,0,0,2
"11277","St Francis PA","Central Conn",2,4,0.666666666666667,6
"11278","St Francis PA","Cincinnati",1,0,0,1
"11279","St Francis PA","Colgate",2,0,0,2
"11280","St Francis PA","Cornell",1,1,0.5,2
"11281","St Francis PA","Dayton",1,0,0,1
"11282","St Francis PA","Denver",1,0,0,1
"11283","St Francis PA","Drexel",1,0,0,1
"11284","St Francis PA","Duquesne",1,1,0.5,2
"11285","St Francis PA","F Dickinson",1,5,0.833333333333333,6
"11286","St Francis PA","Fordham",1,0,0,1
"11287","St Francis PA","George Mason",1,0,0,1
"11288","St Francis PA","Kent",1,0,0,1
"11289","St Francis PA","Lafayette",1,0,0,1
"11290","St Francis PA","Lehigh",3,0,0,3
"11291","St Francis PA","Long Island",3,2,0.4,5
"11292","St Francis PA","MD E Shore",0,1,1,1
"11293","St Francis PA","Monmouth NJ",1,1,0.5,2
"11294","St Francis PA","Mt St Mary's",4,2,0.333333333333333,6
"11295","St Francis PA","Navy",0,2,1,2
"11296","St Francis PA","Niagara",1,0,0,1
"11297","St Francis PA","NJIT",2,0,0,2
"11298","St Francis PA","Notre Dame",1,0,0,1
"11299","St Francis PA","Penn St",1,0,0,1
"11300","St Francis PA","Quinnipiac",2,0,0,2
"11301","St Francis PA","Robert Morris",6,1,0.142857142857143,7
"11302","St Francis PA","Rutgers",0,1,1,1
"11303","St Francis PA","Sacred Heart",1,4,0.8,5
"11304","St Francis PA","St Francis NY",5,1,0.166666666666667,6
"11305","St Francis PA","Texas",1,0,0,1
"11306","St Francis PA","Wagner",4,1,0.2,5
"11307","St Francis PA","Youngstown St",1,0,0,1
"11308","St Francis PA","Keystone",0,1,1,1
"11309","St John's","Baylor",1,0,0,1
"11310","St John's","Bucknell",0,1,1,1
"11311","St John's","Butler",2,2,0.5,4
"11312","St John's","Cincinnati",0,1,1,1
"11313","St John's","Col Charleston",0,1,1,1
"11314","St John's","Columbia",0,1,1,1
"11315","St John's","Connecticut",0,1,1,1
"11316","St John's","Creighton",2,2,0.5,4
"11317","St John's","Dartmouth",0,1,1,1
"11318","St John's","DePaul",2,4,0.666666666666667,6
"11319","St John's","Detroit",0,1,1,1
"11320","St John's","Duke",1,0,0,1
"11321","St John's","F Dickinson",0,1,1,1
"11322","St John's","FL Gulf Coast",0,1,1,1
"11323","St John's","Fordham",0,3,1,3
"11324","St John's","Georgetown",4,2,0.333333333333333,6
"11325","St John's","Georgia Tech",0,1,1,1
"11326","St John's","Gonzaga",1,0,0,1
"11327","St John's","Holy Cross",0,1,1,1
"11328","St John's","Long Beach St",0,1,1,1
"11329","St John's","Long Island",0,1,1,1
"11330","St John's","Longwood",0,1,1,1
"11331","St John's","Louisville",1,0,0,1
"11332","St John's","Marquette",1,4,0.8,5
"11333","St John's","Minnesota",0,1,1,1
"11334","St John's","Monmouth NJ",0,1,1,1
"11335","St John's","Murray St",1,0,0,1
"11336","St John's","Niagara",0,1,1,1
"11337","St John's","NJIT",0,2,1,2
"11338","St John's","Notre Dame",1,1,0.5,2
"11339","St John's","Penn St",1,0,0,1
"11340","St John's","Pittsburgh",1,0,0,1
"11341","St John's","Providence",4,3,0.428571428571429,7
"11342","St John's","Rutgers",1,1,0.5,2
"11343","St John's","San Francisco",1,1,0.5,2
"11344","St John's","Seton Hall",1,4,0.8,5
"11345","St John's","South Carolina",0,1,1,1
"11346","St John's","South Florida",0,1,1,1
"11347","St John's","St Francis NY",0,1,1,1
"11348","St John's","St Mary's CA",0,1,1,1
"11349","St John's","Syracuse",2,1,0.333333333333333,3
"11350","St John's","Tulane",0,1,1,1
"11351","St John's","UNC Asheville",1,0,0,1
"11352","St John's","Villanova",5,0,0,5
"11353","St John's","Wagner",0,1,1,1
"11354","St John's","Wisconsin",1,0,0,1
"11355","St John's","Xavier",2,2,0.5,4
"11356","St John's","Youngstown St",0,1,1,1
"11357","St John's","Franklin Pierce",0,1,1,1
"11358","St Joseph's PA","American Univ",0,1,1,1
"11359","St Joseph's PA","Binghamton",0,1,1,1
"11360","St Joseph's PA","Boston Univ",0,1,1,1
"11361","St Joseph's PA","Butler",1,0,0,1
"11362","St Joseph's PA","Charlotte",1,0,0,1
"11363","St Joseph's PA","Coppin St",0,1,1,1
"11364","St Joseph's PA","Creighton",2,0,0,2
"11365","St Joseph's PA","Davidson",0,1,1,1
"11366","St Joseph's PA","Dayton",2,3,0.6,5
"11367","St Joseph's PA","Denver",1,1,0.5,2
"11368","St Joseph's PA","Drexel",0,3,1,3
"11369","St Joseph's PA","Duquesne",1,2,0.666666666666667,3
"11370","St Joseph's PA","Fairfield",1,0,0,1
"11371","St Joseph's PA","F Dickinson",1,0,0,1
"11372","St Joseph's PA","Florida St",1,0,0,1
"11373","St Joseph's PA","Fordham",1,4,0.8,5
"11374","St Joseph's PA","George Mason",0,2,1,2
"11375","St Joseph's PA","Gonzaga",1,0,0,1
"11376","St Joseph's PA","G Washington",2,1,0.333333333333333,3
"11377","St Joseph's PA","Harvard",0,1,1,1
"11378","St Joseph's PA","Iona",0,1,1,1
"11379","St Joseph's PA","La Salle",3,2,0.4,5
"11380","St Joseph's PA","Long Island",0,1,1,1
"11381","St Joseph's PA","Loyola MD",0,2,1,2
"11382","St Joseph's PA","LSU",1,0,0,1
"11383","St Joseph's PA","Marist",0,2,1,2
"11384","St Joseph's PA","Massachusetts",2,3,0.6,5
"11385","St Joseph's PA","Morgan St",0,1,1,1
"11386","St Joseph's PA","Notre Dame",0,1,1,1
"11387","St Joseph's PA","Penn",1,2,0.666666666666667,3
"11388","St Joseph's PA","Rhode Island",1,4,0.8,5
"11389","St Joseph's PA","Richmond",2,1,0.333333333333333,3
"11390","St Joseph's PA","Siena",0,1,1,1
"11391","St Joseph's PA","St Bonaventure",4,2,0.333333333333333,6
"11392","St Joseph's PA","St Louis",3,0,0,3
"11393","St Joseph's PA","Temple",1,2,0.666666666666667,3
"11394","St Joseph's PA","VA Commonwealth",2,2,0.5,4
"11395","St Joseph's PA","Vermont",0,2,1,2
"11396","St Joseph's PA","Villanova",3,0,0,3
"11397","St Joseph's PA","Washington St",0,1,1,1
"11398","St Joseph's PA","W Kentucky",1,0,0,1
"11399","St Joseph's PA","Xavier",0,1,1,1
"11400","St Joseph's PA","Yale",0,1,1,1
"11401","St Louis","Bowling Green",0,1,1,1
"11402","St Louis","Bradley",0,1,1,1
"11403","St Louis","Butler",0,2,1,2
"11404","St Louis","Charlotte",0,1,1,1
"11405","St Louis","Davidson",1,0,0,1
"11406","St Louis","Dayton",3,2,0.4,5
"11407","St Louis","Duquesne",3,3,0.5,6
"11408","St Louis","Edwardsville",0,3,1,3
"11409","St Louis","E Illinois",0,1,1,1
"11410","St Louis","Fordham",1,2,0.666666666666667,3
"11411","St Louis","George Mason",2,2,0.5,4
"11412","St Louis","G Washington",1,2,0.666666666666667,3
"11413","St Louis","Indiana St",0,2,1,2
"11414","St Louis","Kansas",1,0,0,1
"11415","St Louis","La Salle",0,3,1,3
"11416","St Louis","Loy Marymount",0,1,1,1
"11417","St Louis","Massachusetts",1,2,0.666666666666667,3
"11418","St Louis","Mississippi St",1,0,0,1
"11419","St Louis","NC A&T",0,2,1,2
"11420","St Louis","New Mexico",0,1,1,1
"11421","St Louis","North Texas",0,1,1,1
"11422","St Louis","Old Dominion",0,1,1,1
"11423","St Louis","Oral Roberts",0,1,1,1
"11424","St Louis","Rhode Island",3,1,0.25,4
"11425","St Louis","Richmond",1,2,0.666666666666667,3
"11426","St Louis","Santa Clara",1,0,0,1
"11427","St Louis","Savannah St",0,1,1,1
"11428","St Louis","SC Upstate",0,1,1,1
"11429","St Louis","S Dakota St",1,0,0,1
"11430","St Louis","SE Missouri St",0,1,1,1
"11431","St Louis","S Illinois",0,3,1,3
"11432","St Louis","St Bonaventure",2,2,0.5,4
"11433","St Louis","St Joseph's PA",0,3,1,3
"11434","St Louis","TAM C. Christi",1,0,0,1
"11435","St Louis","Temple",1,0,0,1
"11436","St Louis","Texas A&M",0,1,1,1
"11437","St Louis","TN Martin",0,1,1,1
"11438","St Louis","TX Pan American",0,1,1,1
"11439","St Louis","VA Commonwealth",3,2,0.4,5
"11440","St Louis","Valparaiso",0,2,1,2
"11441","St Louis","Vanderbilt",1,1,0.5,2
"11442","St Louis","Vermont",0,1,1,1
"11443","St Louis","Washington",1,0,0,1
"11444","St Louis","Wichita St",2,0,0,2
"11445","St Louis","Wisconsin",1,0,0,1
"11446","St Louis","Wofford",0,1,1,1
"11447","St Louis","Xavier",1,0,0,1
"11448","St Louis","Yale",0,1,1,1
"11449","St Louis","Rockhurst",0,2,1,2
"11450","St Mary's CA","Akron",0,1,1,1
"11451","St Mary's CA","Alcorn St",0,1,1,1
"11452","St Mary's CA","American Univ",0,1,1,1
"11453","St Mary's CA","Boise St",1,1,0.5,2
"11454","St Mary's CA","BYU",3,3,0.5,6
"11455","St Mary's CA","Cal Poly SLO",0,2,1,2
"11456","St Mary's CA","Creighton",0,2,1,2
"11457","St Mary's CA","Denver",0,1,1,1
"11458","St Mary's CA","Drake",0,2,1,2
"11459","St Mary's CA","Drexel",0,1,1,1
"11460","St Mary's CA","E Washington",0,2,1,2
"11461","St Mary's CA","George Mason",1,0,0,1
"11462","St Mary's CA","Georgia Tech",1,0,0,1
"11463","St Mary's CA","Gonzaga",7,0,0,7
"11464","St Mary's CA","Harvard",0,1,1,1
"11465","St Mary's CA","Hawaii",1,0,0,1
"11466","St Mary's CA","Jackson St",0,1,1,1
"11467","St Mary's CA","Louisiana Tech",0,1,1,1
"11468","St Mary's CA","Loy Marymount",0,6,1,6
"11469","St Mary's CA","Morgan St",0,1,1,1
"11470","St Mary's CA","Murray St",0,1,1,1
"11471","St Mary's CA","N Dakota St",0,1,1,1
"11472","St Mary's CA","New Mexico St",0,1,1,1
"11473","St Mary's CA","Northeastern",0,1,1,1
"11474","St Mary's CA","Northern Arizona",1,0,0,1
"11475","St Mary's CA","Northern Iowa",1,0,0,1
"11476","St Mary's CA","Pacific",1,5,0.833333333333333,6
"11477","St Mary's CA","Pepperdine",1,6,0.857142857142857,7
"11478","St Mary's CA","Portland",1,6,0.857142857142857,7
"11479","St Mary's CA","Rhode Island",0,1,1,1
"11480","St Mary's CA","San Diego",1,5,0.833333333333333,6
"11481","St Mary's CA","San Francisco",1,5,0.833333333333333,6
"11482","St Mary's CA","Santa Clara",2,4,0.666666666666667,6
"11483","St Mary's CA","South Carolina",1,0,0,1
"11484","St Mary's CA","St John's",1,0,0,1
"11485","St Mary's CA","UC Irvine",0,1,1,1
"11486","St Mary's CA","Utah St",0,1,1,1
"11487","St Mary's CA","Yale",0,1,1,1
"11488","St Mary's CA","Wm Jessup",0,1,1,1
"11489","St Mary's CA","Cal St-LA",0,1,1,1
"11490","Stony Brook","Albany NY",5,4,0.444444444444444,9
"11491","Stony Brook","American Univ",0,1,1,1
"11492","Stony Brook","Binghamton",0,7,1,7
"11493","Stony Brook","Boston Univ",0,2,1,2
"11494","Stony Brook","Canisius",1,1,0.5,2
"11495","Stony Brook","Cincinnati",1,0,0,1
"11496","Stony Brook","Columbia",1,2,0.666666666666667,3
"11497","Stony Brook","Connecticut",1,0,0,1
"11498","Stony Brook","Cornell",0,2,1,2
"11499","Stony Brook","Detroit",0,1,1,1
"11500","Stony Brook","E Illinois",0,1,1,1
"11501","Stony Brook","F Dickinson",0,1,1,1
"11502","Stony Brook","FL Atlantic",0,1,1,1
"11503","Stony Brook","Georgia",1,0,0,1
"11504","Stony Brook","Hartford",1,6,0.857142857142857,7
"11505","Stony Brook","Hofstra",1,0,0,1
"11506","Stony Brook","Indiana",1,0,0,1
"11507","Stony Brook","La Salle",1,0,0,1
"11508","Stony Brook","Long Island",0,1,1,1
"11509","Stony Brook","Loyola MD",0,2,1,2
"11510","Stony Brook","Maine",0,7,1,7
"11511","Stony Brook","Manhattan",0,1,1,1
"11512","Stony Brook","Marist",0,2,1,2
"11513","Stony Brook","Maryland",1,0,0,1
"11514","Stony Brook","MD Baltimore Co",0,2,1,2
"11515","Stony Brook","New Hampshire",2,4,0.666666666666667,6
"11516","Stony Brook","Northeastern",0,1,1,1
"11517","Stony Brook","Princeton",1,0,0,1
"11518","Stony Brook","Providence",1,0,0,1
"11519","Stony Brook","Rider",0,1,1,1
"11520","Stony Brook","Sacred Heart",1,1,0.5,2
"11521","Stony Brook","Seton Hall",1,0,0,1
"11522","Stony Brook","St Francis NY",1,1,0.5,2
"11523","Stony Brook","Toledo",1,0,0,1
"11524","Stony Brook","VA Commonwealth",1,0,0,1
"11525","Stony Brook","Vermont",4,3,0.428571428571429,7
"11526","Stony Brook","Washington",0,1,1,1
"11527","Stony Brook","W Kentucky",0,1,1,1
"11528","Stony Brook","Haverford",0,1,1,1
"11529","Stony Brook","MA Lowell",0,4,1,4
"11530","Stony Brook","UMBC",0,4,1,4
"11531","Stony Brook","Merchant Marine",0,1,1,1
"11532","Stony Brook","Thomas Aquinas",0,1,1,1
"11533","St Peter's","Binghamton",1,1,0.5,2
"11534","St Peter's","Boston Univ",2,1,0.333333333333333,3
"11535","St Peter's","Brown",1,0,0,1
"11536","St Peter's","Canisius",6,0,0,6
"11537","St Peter's","Central Conn",0,2,1,2
"11538","St Peter's","Cornell",0,3,1,3
"11539","St Peter's","Fairfield",3,5,0.625,8
"11540","St Peter's","F Dickinson",1,2,0.666666666666667,3
"11541","St Peter's","Hampton",1,1,0.5,2
"11542","St Peter's","Hartford",2,0,0,2
"11543","St Peter's","Iona",4,2,0.333333333333333,6
"11544","St Peter's","Kent",1,0,0,1
"11545","St Peter's","La Salle",1,0,0,1
"11546","St Peter's","Long Island",1,1,0.5,2
"11547","St Peter's","Loyola-Chicago",1,0,0,1
"11548","St Peter's","Loyola MD",2,0,0,2
"11549","St Peter's","Manhattan",8,0,0,8
"11550","St Peter's","Marist",3,3,0.5,6
"11551","St Peter's","Monmouth NJ",1,3,0.75,4
"11552","St Peter's","Niagara",4,2,0.333333333333333,6
"11553","St Peter's","Norfolk St",1,0,0,1
"11554","St Peter's","Princeton",0,1,1,1
"11555","St Peter's","Quinnipiac",2,2,0.5,4
"11556","St Peter's","Rider",5,2,0.285714285714286,7
"11557","St Peter's","Rutgers",0,2,1,2
"11558","St Peter's","Seton Hall",2,1,0.333333333333333,3
"11559","St Peter's","Siena",2,4,0.666666666666667,6
"11560","St Peter's","Tennessee St",0,1,1,1
"11561","Syracuse","Alcorn St",0,1,1,1
"11562","Syracuse","Arkansas",0,1,1,1
"11563","Syracuse","Baylor",0,1,1,1
"11564","Syracuse","Binghamton",0,1,1,1
"11565","Syracuse","Boston College",1,3,0.75,4
"11566","Syracuse","California",1,1,0.5,2
"11567","Syracuse","Canisius",0,1,1,1
"11568","Syracuse","Central Conn",0,1,1,1
"11569","Syracuse","Cincinnati",0,1,1,1
"11570","Syracuse","Clemson",1,1,0.5,2
"11571","Syracuse","Colgate",0,3,1,3
"11572","Syracuse","Connecticut",1,0,0,1
"11573","Syracuse","Cornell",0,2,1,2
"11574","Syracuse","DePaul",0,1,1,1
"11575","Syracuse","Detroit",0,1,1,1
"11576","Syracuse","Duke",3,1,0.25,4
"11577","Syracuse","E Michigan",0,2,1,2
"11578","Syracuse","Florida St",0,2,1,2
"11579","Syracuse","Fordham",0,1,1,1
"11580","Syracuse","Georgetown",2,0,0,2
"11581","Syracuse","Georgia Tech",1,1,0.5,2
"11582","Syracuse","Hampton",0,1,1,1
"11583","Syracuse","High Point",0,1,1,1
"11584","Syracuse","Holy Cross",0,1,1,1
"11585","Syracuse","Indiana",0,1,1,1
"11586","Syracuse","Iowa",0,1,1,1
"11587","Syracuse","Kennesaw",0,1,1,1
"11588","Syracuse","Long Beach St",0,2,1,2
"11589","Syracuse","Louisiana Tech",0,1,1,1
"11590","Syracuse","Louisville",1,2,0.666666666666667,3
"11591","Syracuse","Loyola MD",0,1,1,1
"11592","Syracuse","Marquette",1,0,0,1
"11593","Syracuse","Maryland",0,1,1,1
"11594","Syracuse","Miami FL",1,2,0.666666666666667,3
"11595","Syracuse","Michigan",1,0,0,1
"11596","Syracuse","Minnesota",0,1,1,1
"11597","Syracuse","Monmouth NJ",0,1,1,1
"11598","Syracuse","NC State",2,1,0.333333333333333,3
"11599","Syracuse","North Carolina",1,1,0.5,2
"11600","Syracuse","Notre Dame",0,3,1,3
"11601","Syracuse","Pittsburgh",3,2,0.4,5
"11602","Syracuse","Princeton",0,1,1,1
"11603","Syracuse","Providence",0,2,1,2
"11604","Syracuse","Rutgers",0,1,1,1
"11605","Syracuse","San Diego St",0,1,1,1
"11606","Syracuse","Seton Hall",0,1,1,1
"11607","Syracuse","South Florida",0,1,1,1
"11608","Syracuse","St Francis NY",0,1,1,1
"11609","Syracuse","St John's",1,2,0.666666666666667,3
"11610","Syracuse","Temple",1,0,0,1
"11611","Syracuse","Villanova",2,2,0.5,4
"11612","Syracuse","Virginia",2,0,0,2
"11613","Syracuse","Virginia Tech",0,3,1,3
"11614","Syracuse","Wagner",0,1,1,1
"11615","Syracuse","Wake Forest",0,2,1,2
"11616","TAM C. Christi","Bradley",1,0,0,1
"11617","TAM C. Christi","Cent Arkansas",1,4,0.8,5
"11618","TAM C. Christi","C Michigan",1,0,0,1
"11619","TAM C. Christi","CS Fullerton",2,0,0,2
"11620","TAM C. Christi","CS Northridge",1,1,0.5,2
"11621","TAM C. Christi","Denver",3,0,0,3
"11622","TAM C. Christi","Georgetown",1,0,0,1
"11623","TAM C. Christi","Houston",2,0,0,2
"11624","TAM C. Christi","Houston Bap",1,3,0.75,4
"11625","TAM C. Christi","Iowa",1,0,0,1
"11626","TAM C. Christi","Iowa St",1,0,0,1
"11627","TAM C. Christi","IPFW",0,1,1,1
"11628","TAM C. Christi","Lamar",2,2,0.5,4
"11629","TAM C. Christi","McNeese St",1,4,0.8,5
"11630","TAM C. Christi","Minnesota",1,0,0,1
"11631","TAM C. Christi","MS Valley St",0,1,1,1
"11632","TAM C. Christi","New Orleans",1,3,0.75,4
"11633","TAM C. Christi","Nicholls St",1,4,0.8,5
"11634","TAM C. Christi","Northwestern LA",2,2,0.5,4
"11635","TAM C. Christi","Oklahoma",2,0,0,2
"11636","TAM C. Christi","Oral Roberts",2,2,0.5,4
"11637","TAM C. Christi","Radford",1,0,0,1
"11638","TAM C. Christi","Rice",1,0,0,1
"11639","TAM C. Christi","Sam Houston St",6,1,0.142857142857143,7
"11640","TAM C. Christi","SE Louisiana",1,3,0.75,4
"11641","TAM C. Christi","SF Austin",4,1,0.2,5
"11642","TAM C. Christi","South Alabama",1,0,0,1
"11643","TAM C. Christi","St Louis",0,1,1,1
"11644","TAM C. Christi","Tennessee Tech",1,0,0,1
"11645","TAM C. Christi","Texas A&M",1,0,0,1
"11646","TAM C. Christi","Toledo",1,0,0,1
"11647","TAM C. Christi","TX Pan American",0,1,1,1
"11648","TAM C. Christi","Utah St",1,0,0,1
"11649","TAM C. Christi","UT San Antonio",3,0,0,3
"11650","TAM C. Christi","Abilene Chr",0,3,1,3
"11651","TAM C. Christi","Huston-Tillot",0,1,1,1
"11652","TAM C. Christi","Incarnate Word",2,1,0.333333333333333,3
"11653","TAM C. Christi","Jarvis Chr",0,1,1,1
"11654","TAM C. Christi","Our Lady Lake",0,1,1,1
"11655","TAM C. Christi","Permian Basin",1,0,0,1
"11656","TCU","Baylor",7,0,0,7
"11657","TCU","Bradley",0,1,1,1
"11658","TCU","Cal Poly SLO",0,1,1,1
"11659","TCU","Furman",0,1,1,1
"11660","TCU","Grambling",0,2,1,2
"11661","TCU","Harvard",1,0,0,1
"11662","TCU","Houston",1,0,0,1
"11663","TCU","Iowa St",6,0,0,6
"11664","TCU","Kansas",6,1,0.142857142857143,7
"11665","TCU","Kansas St",5,2,0.285714285714286,7
"11666","TCU","Longwood",1,0,0,1
"11667","TCU","McNeese St",0,1,1,1
"11668","TCU","Mississippi",0,1,1,1
"11669","TCU","Mississippi St",0,2,1,2
"11670","TCU","MS Valley St",0,2,1,2
"11671","TCU","Navy",0,1,1,1
"11672","TCU","New Orleans",0,1,1,1
"11673","TCU","Northwestern",1,0,0,1
"11674","TCU","Oklahoma",5,1,0.166666666666667,6
"11675","TCU","Oklahoma St",5,1,0.166666666666667,6
"11676","TCU","Prairie View",0,2,1,2
"11677","TCU","Radford",0,1,1,1
"11678","TCU","Rice",0,1,1,1
"11679","TCU","SMU",2,0,0,2
"11680","TCU","Southern Univ",0,1,1,1
"11681","TCU","Southern Utah",0,1,1,1
"11682","TCU","Tennessee St",0,1,1,1
"11683","TCU","Texas",6,0,0,6
"11684","TCU","Texas Tech",4,2,0.333333333333333,6
"11685","TCU","Tulsa",1,2,0.666666666666667,3
"11686","TCU","TX Pan American",0,1,1,1
"11687","TCU","TX Southern",0,1,1,1
"11688","TCU","UAB",0,1,1,1
"11689","TCU","UT San Antonio",0,1,1,1
"11690","TCU","Washington St",0,2,1,2
"11691","TCU","West Virginia",6,0,0,6
"11692","TCU","Abilene Chr",0,1,1,1
"11693","TCU","AK Anchorage",0,1,1,1
"11694","Temple","Alcorn St",0,1,1,1
"11695","Temple","American Univ",0,1,1,1
"11696","Temple","Bowling Green",0,1,1,1
"11697","Temple","Buffalo",0,1,1,1
"11698","Temple","Butler",1,0,0,1
"11699","Temple","Canisius",1,0,0,1
"11700","Temple","Charlotte",0,2,1,2
"11701","Temple","Cincinnati",3,1,0.25,4
"11702","Temple","Clemson",1,0,0,1
"11703","Temple","Connecticut",2,2,0.5,4
"11704","Temple","Dayton",0,1,1,1
"11705","Temple","Delaware",0,2,1,2
"11706","Temple","Delaware St",0,1,1,1
"11707","Temple","Detroit",0,1,1,1
"11708","Temple","Duke",2,0,0,2
"11709","Temple","Duquesne",1,0,0,1
"11710","Temple","East Carolina",0,2,1,2
"11711","Temple","Fordham",0,1,1,1
"11712","Temple","Georgia",0,1,1,1
"11713","Temple","G Washington",0,1,1,1
"11714","Temple","Houston",2,1,0.333333333333333,3
"11715","Temple","Kansas",1,1,0.5,2
"11716","Temple","Kent",1,1,0.5,2
"11717","Temple","La Salle",1,2,0.666666666666667,3
"11718","Temple","Long Island",0,2,1,2
"11719","Temple","Louisiana Tech",0,1,1,1
"11720","Temple","Louisville",2,0,0,2
"11721","Temple","Massachusetts",0,1,1,1
"11722","Temple","Memphis",2,2,0.5,4
"11723","Temple","Penn",0,3,1,3
"11724","Temple","Rhode Island",0,1,1,1
"11725","Temple","Rice",0,1,1,1
"11726","Temple","Richmond",0,1,1,1
"11727","Temple","Rutgers",1,1,0.5,2
"11728","Temple","SMU",4,1,0.2,5
"11729","Temple","South Florida",1,3,0.75,4
"11730","Temple","St Bonaventure",1,0,0,1
"11731","Temple","St Joseph's PA",2,1,0.333333333333333,3
"11732","Temple","St Louis",0,1,1,1
"11733","Temple","Syracuse",0,1,1,1
"11734","Temple","Texas",1,0,0,1
"11735","Temple","Towson",1,2,0.666666666666667,3
"11736","Temple","Tulane",0,2,1,2
"11737","Temple","Tulsa",2,0,0,2
"11738","Temple","TX Southern",1,0,0,1
"11739","Temple","UAB",0,1,1,1
"11740","Temple","UCF",2,3,0.6,5
"11741","Temple","UNLV",1,0,0,1
"11742","Temple","VA Commonwealth",0,1,1,1
"11743","Temple","Villanova",2,1,0.333333333333333,3
"11744","Temple","Wagner",0,1,1,1
"11745","Temple","Xavier",1,0,0,1
"11746","Tennessee","Alabama",2,2,0.5,4
"11747","Tennessee","Arkansas",3,2,0.4,5
"11748","Tennessee","Auburn",0,4,1,4
"11749","Tennessee","Butler",0,1,1,1
"11750","Tennessee","Citadel",0,1,1,1
"11751","Tennessee","ETSU",0,1,1,1
"11752","Tennessee","Florida",4,1,0.2,5
"11753","Tennessee","Georgetown",1,0,0,1
"11754","Tennessee","Georgia",3,1,0.25,4
"11755","Tennessee","Kansas",1,0,0,1
"11756","Tennessee","Kansas St",0,1,1,1
"11757","Tennessee","Kennesaw",0,1,1,1
"11758","Tennessee","Kentucky",3,1,0.25,4
"11759","Tennessee","LSU",1,3,0.75,4
"11760","Tennessee","Marquette",1,0,0,1
"11761","Tennessee","Massachusetts",0,1,1,1
"11762","Tennessee","Memphis",1,0,0,1
"11763","Tennessee","Mercer",0,1,1,1
"11764","Tennessee","Mississippi",3,1,0.25,4
"11765","Tennessee","Mississippi St",1,3,0.75,4
"11766","Tennessee","Missouri",1,3,0.75,4
"11767","Tennessee","Morehead St",0,1,1,1
"11768","Tennessee","NC State",2,0,0,2
"11769","Tennessee","Oakland",0,1,1,1
"11770","Tennessee","Oklahoma St",1,0,0,1
"11771","Tennessee","Presbyterian",0,1,1,1
"11772","Tennessee","Santa Clara",0,1,1,1
"11773","Tennessee","SC Upstate",0,1,1,1
"11774","Tennessee","South Carolina",1,4,0.8,5
"11775","Tennessee","Tennessee St",0,2,1,2
"11776","Tennessee","Tennessee Tech",0,2,1,2
"11777","Tennessee","Texas A&M",3,1,0.25,4
"11778","Tennessee","TX Southern",0,1,1,1
"11779","Tennessee","UNC Asheville",0,1,1,1
"11780","Tennessee","UTEP",1,0,0,1
"11781","Tennessee","VA Commonwealth",1,0,0,1
"11782","Tennessee","Vanderbilt",2,5,0.714285714285714,7
"11783","Tennessee","Virginia",1,1,0.5,2
"11784","Tennessee","Wake Forest",0,1,1,1
"11785","Tennessee","W Carolina",0,1,1,1
"11786","Tennessee","Wichita St",1,1,0.5,2
"11787","Tennessee","Xavier",1,2,0.666666666666667,3
"11788","Tennessee","Tusculum",0,1,1,1
"11789","Tennessee St","Alabama A&M",1,1,0.5,2
"11790","Tennessee St","Auburn",1,0,0,1
"11791","Tennessee St","Austin Peay",2,1,0.333333333333333,3
"11792","Tennessee St","Belmont",5,1,0.166666666666667,6
"11793","Tennessee St","BYU",1,0,0,1
"11794","Tennessee St","Drexel",1,1,0.5,2
"11795","Tennessee St","Edwardsville",1,2,0.666666666666667,3
"11796","Tennessee St","E Illinois",2,1,0.333333333333333,3
"11797","Tennessee St","E Kentucky",5,1,0.166666666666667,6
"11798","Tennessee St","Georgia St",1,0,0,1
"11799","Tennessee St","Hampton",2,0,0,2
"11800","Tennessee St","Hawaii",1,0,0,1
"11801","Tennessee St","Illinois St",1,0,0,1
"11802","Tennessee St","Jacksonville St",2,4,0.666666666666667,6
"11803","Tennessee St","Kennesaw",0,1,1,1
"11804","Tennessee St","Lipscomb",2,0,0,2
"11805","Tennessee St","Loyola MD",1,0,0,1
"11806","Tennessee St","Miami OH",1,0,0,1
"11807","Tennessee St","Middle Tenn St",2,0,0,2
"11808","Tennessee St","Minnesota",1,0,0,1
"11809","Tennessee St","Missouri",1,0,0,1
"11810","Tennessee St","Monmouth NJ",1,0,0,1
"11811","Tennessee St","Morehead St",5,1,0.166666666666667,6
"11812","Tennessee St","Murray St",3,0,0,3
"11813","Tennessee St","New Mexico St",1,0,0,1
"11814","Tennessee St","SC Upstate",1,1,0.5,2
"11815","Tennessee St","S Dakota St",1,0,0,1
"11816","Tennessee St","SE Missouri St",2,1,0.333333333333333,3
"11817","Tennessee St","S Illinois",2,0,0,2
"11818","Tennessee St","South Alabama",0,1,1,1
"11819","Tennessee St","St Francis NY",1,0,0,1
"11820","Tennessee St","St Peter's",1,0,0,1
"11821","Tennessee St","TCU",1,0,0,1
"11822","Tennessee St","Tennessee",2,0,0,2
"11823","Tennessee St","Tennessee Tech",2,4,0.666666666666667,6
"11824","Tennessee St","TN Martin",2,1,0.333333333333333,3
"11825","Tennessee St","Vanderbilt",1,0,0,1
"11826","Tennessee St","Virginia",1,0,0,1
"11827","Tennessee St","Wichita St",1,0,0,1
"11828","Tennessee St","W Michigan",1,0,0,1
"11829","Tennessee St","Fisk",0,2,1,2
"11830","Tennessee St","Reinhardt",0,1,1,1
"11831","Tennessee St","MTSU",1,0,0,1
"11832","Tennessee Tech","Alabama",1,0,0,1
"11833","Tennessee Tech","Auburn",1,0,0,1
"11834","Tennessee Tech","Austin Peay",1,2,0.666666666666667,3
"11835","Tennessee Tech","Belmont",5,1,0.166666666666667,6
"11836","Tennessee Tech","Chattanooga",0,1,1,1
"11837","Tennessee Tech","Coastal Car",0,1,1,1
"11838","Tennessee Tech","Edwardsville",2,2,0.5,4
"11839","Tennessee Tech","E Illinois",1,2,0.666666666666667,3
"11840","Tennessee Tech","E Kentucky",4,2,0.333333333333333,6
"11841","Tennessee Tech","ETSU",1,2,0.666666666666667,3
"11842","Tennessee Tech","Evansville",1,0,0,1
"11843","Tennessee Tech","Gardner Webb",1,0,0,1
"11844","Tennessee Tech","IPFW",1,0,0,1
"11845","Tennessee Tech","Jacksonville St",2,4,0.666666666666667,6
"11846","Tennessee Tech","Lamar",0,1,1,1
"11847","Tennessee Tech","Lipscomb",2,1,0.333333333333333,3
"11848","Tennessee Tech","Loyola-Chicago",1,1,0.5,2
"11849","Tennessee Tech","Missouri KC",0,2,1,2
"11850","Tennessee Tech","Morehead St",5,2,0.285714285714286,7
"11851","Tennessee Tech","Murray St",3,0,0,3
"11852","Tennessee Tech","North Florida",0,2,1,2
"11853","Tennessee Tech","Oklahoma St",1,0,0,1
"11854","Tennessee Tech","SE Louisiana",1,1,0.5,2
"11855","Tennessee Tech","SE Missouri St",3,0,0,3
"11856","Tennessee Tech","South Florida",1,0,0,1
"11857","Tennessee Tech","TAM C. Christi",0,1,1,1
"11858","Tennessee Tech","Tennessee",2,0,0,2
"11859","Tennessee Tech","Tennessee St",4,2,0.333333333333333,6
"11860","Tennessee Tech","TN Martin",1,2,0.666666666666667,3
"11861","Tennessee Tech","Tulane",1,0,0,1
"11862","Tennessee Tech","TX Pan American",1,0,0,1
"11863","Tennessee Tech","USC",1,0,0,1
"11864","Tennessee Tech","Utah Valley",1,1,0.5,2
"11865","Tennessee Tech","WI Green Bay",1,1,0.5,2
"11866","Tennessee Tech","WI Milwaukee",1,1,0.5,2
"11867","Tennessee Tech","Hillsdale",0,1,1,1
"11868","Tennessee Tech","Hillsdale Bap",0,1,1,1
"11869","Tennessee Tech","Hiwassee",0,1,1,1
"11870","Tennessee Tech","IU Kokomo",0,1,1,1
"11871","Tennessee Tech","Piedmont Bap",0,1,1,1
"11872","Texas","Alcorn St",0,1,1,1
"11873","Texas","Baylor",3,4,0.571428571428571,7
"11874","Texas","BYU",1,0,0,1
"11875","Texas","California",0,1,1,1
"11876","Texas","Connecticut",0,1,1,1
"11877","Texas","Coppin St",0,1,1,1
"11878","Texas","DePaul",0,1,1,1
"11879","Texas","Fresno St",0,1,1,1
"11880","Texas","Georgetown",1,0,0,1
"11881","Texas","Houston Bap",0,1,1,1
"11882","Texas","Iowa",0,1,1,1
"11883","Texas","Iowa St",5,2,0.285714285714286,7
"11884","Texas","Kansas",5,1,0.166666666666667,6
"11885","Texas","Kansas St",3,3,0.5,6
"11886","Texas","Kentucky",1,0,0,1
"11887","Texas","Lipscomb",0,1,1,1
"11888","Texas","Long Beach St",0,1,1,1
"11889","Texas","Mercer",0,1,1,1
"11890","Texas","Michigan St",2,0,0,2
"11891","Texas","Mississippi St",0,1,1,1
"11892","Texas","N Dakota St",0,1,1,1
"11893","Texas","North Carolina",0,2,1,2
"11894","Texas","Oklahoma",5,1,0.166666666666667,6
"11895","Texas","Oklahoma St",5,1,0.166666666666667,6
"11896","Texas","Rice",0,3,1,3
"11897","Texas","Sam Houston St",0,1,1,1
"11898","Texas","SF Austin",0,1,1,1
"11899","Texas","South Alabama",0,1,1,1
"11900","Texas","Stanford",1,0,0,1
"11901","Texas","St Francis PA",0,1,1,1
"11902","Texas","TCU",0,6,1,6
"11903","Texas","Temple",0,1,1,1
"11904","Texas","Texas St",0,3,1,3
"11905","Texas","Texas Tech",1,6,0.857142857142857,7
"11906","Texas","UCLA",1,0,0,1
"11907","Texas","USC",1,0,0,1
"11908","Texas","UT Arlington",0,3,1,3
"11909","Texas","Vanderbilt",0,1,1,1
"11910","Texas","West Virginia",3,4,0.571428571428571,7
"11911","Texas A&M","Alabama",3,1,0.25,4
"11912","Texas A&M","Arizona St",0,1,1,1
"11913","Texas A&M","Arkansas",2,2,0.5,4
"11914","Texas A&M","Ark Pine Bluff",0,1,1,1
"11915","Texas A&M","Army",0,1,1,1
"11916","Texas A&M","Auburn",2,3,0.6,5
"11917","Texas A&M","Baylor",1,0,0,1
"11918","Texas A&M","Buffalo",0,1,1,1
"11919","Texas A&M","Col Charleston",0,1,1,1
"11920","Texas A&M","Dayton",1,0,0,1
"11921","Texas A&M","Florida",3,1,0.25,4
"11922","Texas A&M","Georgia",4,0,0,4
"11923","Texas A&M","Hartford",0,1,1,1
"11924","Texas A&M","Houston",0,2,1,2
"11925","Texas A&M","Houston Bap",0,1,1,1
"11926","Texas A&M","Kansas St",1,0,0,1
"11927","Texas A&M","Kentucky",3,1,0.25,4
"11928","Texas A&M","Louisiana Tech",0,1,1,1
"11929","Texas A&M","LSU",3,3,0.5,6
"11930","Texas A&M","McNeese St",0,1,1,1
"11931","Texas A&M","Mercer",0,1,1,1
"11932","Texas A&M","Mississippi",2,2,0.5,4
"11933","Texas A&M","Mississippi St",1,3,0.75,4
"11934","Texas A&M","Missouri",2,3,0.6,5
"11935","Texas A&M","Missouri St",1,0,0,1
"11936","Texas A&M","MS Valley St",0,1,1,1
"11937","Texas A&M","New Mexico",0,1,1,1
"11938","Texas A&M","New Orleans",0,1,1,1
"11939","Texas A&M","North Texas",1,0,0,1
"11940","Texas A&M","Northwestern LA",0,2,1,2
"11941","Texas A&M","Oklahoma",2,0,0,2
"11942","Texas A&M","Prairie View",0,2,1,2
"11943","Texas A&M","Rice",0,1,1,1
"11944","Texas A&M","Sam Houston St",0,2,1,2
"11945","Texas A&M","SF Austin",0,1,1,1
"11946","Texas A&M","SMU",1,0,0,1
"11947","Texas A&M","South Carolina",1,3,0.75,4
"11948","Texas A&M","Southern Univ",1,0,0,1
"11949","Texas A&M","St Louis",1,0,0,1
"11950","Texas A&M","TAM C. Christi",0,1,1,1
"11951","Texas A&M","Tennessee",1,3,0.75,4
"11952","Texas A&M","Troy",0,1,1,1
"11953","Texas A&M","TX Pan American",0,1,1,1
"11954","Texas A&M","Vanderbilt",3,1,0.25,4
"11955","Texas A&M","Washington St",0,1,1,1
"11956","Texas A&M","Youngstown St",0,1,1,1
"11957","Texas St","Appalachian St",2,0,0,2
"11958","Texas St","Arkansas St",3,1,0.25,4
"11959","Texas St","Ark Little Rock",3,1,0.25,4
"11960","Texas St","Charlotte",1,0,0,1
"11961","Texas St","C Michigan",1,0,0,1
"11962","Texas St","Denver",2,0,0,2
"11963","Texas St","Fordham",0,1,1,1
"11964","Texas St","Ga Southern",2,0,0,2
"11965","Texas St","Georgia St",3,1,0.25,4
"11966","Texas St","Houston",1,0,0,1
"11967","Texas St","Idaho",1,1,0.5,2
"11968","Texas St","Lamar",0,2,1,2
"11969","Texas St","Long Island",1,0,0,1
"11970","Texas St","Louisiana Tech",2,0,0,2
"11971","Texas St","Loy Marymount",1,0,0,1
"11972","Texas St","New Mexico St",2,0,0,2
"11973","Texas St","N Kentucky",0,1,1,1
"11974","Texas St","Northwestern",1,0,0,1
"11975","Texas St","Oral Roberts",2,0,0,2
"11976","Texas St","Prairie View",0,1,1,1
"11977","Texas St","San Jose St",1,1,0.5,2
"11978","Texas St","Seattle",0,3,1,3
"11979","Texas St","SE Missouri St",1,0,0,1
"11980","Texas St","SF Austin",2,0,0,2
"11981","Texas St","SMU",2,0,0,2
"11982","Texas St","South Alabama",1,3,0.75,4
"11983","Texas St","South Dakota",1,0,0,1
"11984","Texas St","Texas",3,0,0,3
"11985","Texas St","Troy",1,3,0.75,4
"11986","Texas St","Tulane",0,1,1,1
"11987","Texas St","TX Pan American",0,1,1,1
"11988","Texas St","UC Riverside",0,1,1,1
"11989","Texas St","ULL",5,0,0,5
"11990","Texas St","ULM",2,2,0.5,4
"11991","Texas St","Utah",2,0,0,2
"11992","Texas St","Utah St",2,0,0,2
"11993","Texas St","UT Arlington",6,1,0.142857142857143,7
"11994","Texas St","UT San Antonio",2,1,0.333333333333333,3
"11995","Texas St","W Kentucky",2,0,0,2
"11996","Texas St","Cedarville",0,1,1,1
"11997","Texas St","Howard Payne",0,1,1,1
"11998","Texas St","Huston-Tillot",0,1,1,1
"11999","Texas St","UT Tyler",0,1,1,1
"12000","Texas St","TX Lutheran",0,1,1,1
"12001","Texas Tech","Air Force",0,1,1,1
"12002","Texas Tech","Alabama",2,0,0,2
"12003","Texas Tech","Arizona",2,0,0,2
"12004","Texas Tech","Arizona St",2,0,0,2
"12005","Texas Tech","Ark Pine Bluff",0,1,1,1
"12006","Texas Tech","Auburn",0,1,1,1
"12007","Texas Tech","Baylor",5,1,0.166666666666667,6
"12008","Texas Tech","Cent Arkansas",0,1,1,1
"12009","Texas Tech","Florida A&M",0,1,1,1
"12010","Texas Tech","Fresno St",0,1,1,1
"12011","Texas Tech","Grambling",0,1,1,1
"12012","Texas Tech","Houston",1,1,0.5,2
"12013","Texas Tech","Houston Bap",0,1,1,1
"12014","Texas Tech","Iowa St",4,2,0.333333333333333,6
"12015","Texas Tech","Jackson St",0,1,1,1
"12016","Texas Tech","Kansas",6,0,0,6
"12017","Texas Tech","Kansas St",5,1,0.166666666666667,6
"12018","Texas Tech","Loyola-Chicago",1,0,0,1
"12019","Texas Tech","Loyola MD",0,1,1,1
"12020","Texas Tech","LSU",2,0,0,2
"12021","Texas Tech","McNeese St",1,0,0,1
"12022","Texas Tech","Missouri St",0,1,1,1
"12023","Texas Tech","Mt St Mary's",0,1,1,1
"12024","Texas Tech","NC A&T",0,1,1,1
"12025","Texas Tech","NE Omaha",0,1,1,1
"12026","Texas Tech","N Kentucky",0,1,1,1
"12027","Texas Tech","Northern Arizona",0,1,1,1
"12028","Texas Tech","North Texas",0,1,1,1
"12029","Texas Tech","Northwestern LA",0,1,1,1
"12030","Texas Tech","Oklahoma",5,1,0.166666666666667,6
"12031","Texas Tech","Oklahoma St",5,2,0.285714285714286,7
"12032","Texas Tech","Pittsburgh",1,0,0,1
"12033","Texas Tech","Prairie View",0,2,1,2
"12034","Texas Tech","S Carolina St",0,1,1,1
"12035","Texas Tech","S Dakota St",0,1,1,1
"12036","Texas Tech","TCU",2,4,0.666666666666667,6
"12037","Texas Tech","Texas",6,1,0.142857142857143,7
"12038","Texas Tech","TX Southern",0,1,1,1
"12039","Texas Tech","UT San Antonio",0,1,1,1
"12040","Texas Tech","West Virginia",6,0,0,6
"12041","TN Martin","Arkansas",1,0,0,1
"12042","TN Martin","Arkansas St",2,1,0.333333333333333,3
"12043","TN Martin","Ark Little Rock",1,0,0,1
"12044","TN Martin","Austin Peay",3,3,0.5,6
"12045","TN Martin","Belmont",3,0,0,3
"12046","TN Martin","Bethune-Cookman",0,1,1,1
"12047","TN Martin","Bradley",1,0,0,1
"12048","TN Martin","Butler",1,0,0,1
"12049","TN Martin","Cent Arkansas",1,0,0,1
"12050","TN Martin","Cincinnati",1,0,0,1
"12051","TN Martin","Colorado",1,0,0,1
"12052","TN Martin","Edwardsville",3,3,0.5,6
"12053","TN Martin","E Illinois",3,3,0.5,6
"12054","TN Martin","E Kentucky",2,1,0.333333333333333,3
"12055","TN Martin","Florida St",1,0,0,1
"12056","TN Martin","IL Chicago",0,1,1,1
"12057","TN Martin","Illinois St",1,0,0,1
"12058","TN Martin","Jackson St",1,0,0,1
"12059","TN Martin","Jacksonville St",2,1,0.333333333333333,3
"12060","TN Martin","Kennesaw",0,1,1,1
"12061","TN Martin","Lipscomb",2,0,0,2
"12062","TN Martin","Longwood",0,2,1,2
"12063","TN Martin","Marquette",1,0,0,1
"12064","TN Martin","MD E Shore",1,0,0,1
"12065","TN Martin","Memphis",1,0,0,1
"12066","TN Martin","Missouri KC",1,0,0,1
"12067","TN Martin","Morehead St",3,1,0.25,4
"12068","TN Martin","Murray St",5,1,0.166666666666667,6
"12069","TN Martin","Nebraska",1,0,0,1
"12070","TN Martin","N Kentucky",0,2,1,2
"12071","TN Martin","Presbyterian",0,2,1,2
"12072","TN Martin","Samford",1,1,0.5,2
"12073","TN Martin","SE Louisiana",1,0,0,1
"12074","TN Martin","SE Missouri St",4,2,0.333333333333333,6
"12075","TN Martin","St Louis",1,0,0,1
"12076","TN Martin","Tennessee St",1,2,0.666666666666667,3
"12077","TN Martin","Tennessee Tech",2,1,0.333333333333333,3
"12078","TN Martin","UNLV",1,0,0,1
"12079","TN Martin","Wyoming",1,0,0,1
"12080","TN Martin","Bethel TN",0,1,1,1
"12081","TN Martin","Champion Bap",0,1,1,1
"12082","TN Martin","Crowley's Ridge",0,1,1,1
"12083","TN Martin","Rochester MI",0,1,1,1
"12084","Toledo","Akron",1,3,0.75,4
"12085","Toledo","Arkansas St",0,2,1,2
"12086","Toledo","Ball St",1,5,0.833333333333333,6
"12087","Toledo","Boston College",0,1,1,1
"12088","Toledo","Bowling Green",0,4,1,4
"12089","Toledo","Bucknell",0,1,1,1
"12090","Toledo","Buffalo",1,2,0.666666666666667,3
"12091","Toledo","Chicago St",1,1,0.5,2
"12092","Toledo","Cleveland St",1,2,0.666666666666667,3
"12093","Toledo","C Michigan",3,4,0.571428571428571,7
"12094","Toledo","Coppin St",0,1,1,1
"12095","Toledo","Detroit",2,2,0.5,4
"12096","Toledo","Duke",1,0,0,1
"12097","Toledo","E Illinois",0,1,1,1
"12098","Toledo","E Michigan",2,6,0.75,8
"12099","Toledo","FL Atlantic",0,1,1,1
"12100","Toledo","FL Gulf Coast",1,0,0,1
"12101","Toledo","Florida A&M",0,1,1,1
"12102","Toledo","IL Chicago",0,1,1,1
"12103","Toledo","Kansas",1,0,0,1
"12104","Toledo","Kent",2,2,0.5,4
"12105","Toledo","Loyola-Chicago",1,0,0,1
"12106","Toledo","McNeese St",0,2,1,2
"12107","Toledo","Miami OH",0,3,1,3
"12108","Toledo","Minnesota",1,0,0,1
"12109","Toledo","N Illinois",2,4,0.666666666666667,6
"12110","Toledo","N Kentucky",0,1,1,1
"12111","Toledo","Northern Arizona",0,1,1,1
"12112","Toledo","Northern Iowa",1,0,0,1
"12113","Toledo","Oakland",1,0,0,1
"12114","Toledo","Ohio",2,2,0.5,4
"12115","Toledo","Oregon",1,0,0,1
"12116","Toledo","Robert Morris",0,2,1,2
"12117","Toledo","Samford",0,1,1,1
"12118","Toledo","Sam Houston St",0,1,1,1
"12119","Toledo","Stony Brook",0,1,1,1
"12120","Toledo","TAM C. Christi",0,1,1,1
"12121","Toledo","VA Commonwealth",1,0,0,1
"12122","Toledo","W Michigan",5,2,0.285714285714286,7
"12123","Toledo","Northwestern OH",0,1,1,1
"12124","Towson","Alabama",1,0,0,1
"12125","Towson","Bethune-Cookman",0,1,1,1
"12126","Towson","Central Conn",0,1,1,1
"12127","Towson","Citadel",0,1,1,1
"12128","Towson","Col Charleston",1,4,0.8,5
"12129","Towson","Coppin St",1,2,0.666666666666667,3
"12130","Towson","Delaware",3,3,0.5,6
"12131","Towson","Drexel",2,4,0.666666666666667,6
"12132","Towson","E Kentucky",1,0,0,1
"12133","Towson","Elon",1,2,0.666666666666667,3
"12134","Towson","F Dickinson",1,0,0,1
"12135","Towson","George Mason",1,1,0.5,2
"12136","Towson","Georgetown",2,0,0,2
"12137","Towson","Georgia St",1,1,0.5,2
"12138","Towson","Hofstra",1,5,0.833333333333333,6
"12139","Towson","James Madison",3,4,0.571428571428571,7
"12140","Towson","Kansas",1,0,0,1
"12141","Towson","Kennesaw",0,1,1,1
"12142","Towson","La Salle",1,0,0,1
"12143","Towson","Loyola MD",1,0,0,1
"12144","Towson","MD Baltimore Co",1,0,0,1
"12145","Towson","Monmouth NJ",0,1,1,1
"12146","Towson","Morgan St",0,2,1,2
"12147","Towson","Navy",1,1,0.5,2
"12148","Towson","N Dakota St",2,0,0,2
"12149","Towson","New Hampshire",0,1,1,1
"12150","Towson","Northeastern",4,1,0.2,5
"12151","Towson","Old Dominion",0,1,1,1
"12152","Towson","Oregon St",1,1,0.5,2
"12153","Towson","Radford",0,1,1,1
"12154","Towson","Sam Houston St",1,0,0,1
"12155","Towson","SF Austin",1,0,0,1
"12156","Towson","Temple",2,1,0.333333333333333,3
"12157","Towson","UNC Wilmington",3,3,0.5,6
"12158","Towson","Vermont",0,1,1,1
"12159","Towson","Villanova",1,0,0,1
"12160","Towson","William & Mary",4,3,0.428571428571429,7
"12161","Towson","Abilene Chr",0,1,1,1
"12162","Towson","Central Penn",0,1,1,1
"12163","Towson","Goucher",0,1,1,1
"12164","Towson","UMBC",0,2,1,2
"12165","Troy","Alabama St",1,2,0.666666666666667,3
"12166","Troy","Alcorn St",0,2,1,2
"12167","Troy","Appalachian St",2,0,0,2
"12168","Troy","Arkansas St",3,3,0.5,6
"12169","Troy","Ark Little Rock",5,2,0.285714285714286,7
"12170","Troy","Austin Peay",1,0,0,1
"12171","Troy","Cent Arkansas",1,1,0.5,2
"12172","Troy","Chattanooga",0,1,1,1
"12173","Troy","FL Atlantic",2,0,0,2
"12174","Troy","Florida Intl",1,1,0.5,2
"12175","Troy","Ga Southern",0,2,1,2
"12176","Troy","Georgia",1,0,0,1
"12177","Troy","Georgia St",3,2,0.4,5
"12178","Troy","Kansas St",1,0,0,1
"12179","Troy","Louisiana Tech",1,0,0,1
"12180","Troy","Middle Tenn St",2,0,0,2
"12181","Troy","Mississippi",2,0,0,2
"12182","Troy","Mississippi St",0,1,1,1
"12183","Troy","Nicholls St",0,2,1,2
"12184","Troy","North Texas",2,0,0,2
"12185","Troy","Santa Barbara",1,0,0,1
"12186","Troy","SE Missouri St",0,1,1,1
"12187","Troy","South Alabama",5,1,0.166666666666667,6
"12188","Troy","Southern Miss",1,0,0,1
"12189","Troy","Texas A&M",1,0,0,1
"12190","Troy","Texas St",3,1,0.25,4
"12191","Troy","UAB",2,0,0,2
"12192","Troy","ULL",5,1,0.166666666666667,6
"12193","Troy","ULM",3,3,0.5,6
"12194","Troy","Utah St",1,0,0,1
"12195","Troy","Utah Valley",2,0,0,2
"12196","Troy","UT Arlington",2,2,0.5,4
"12197","Troy","W Illinois",1,0,0,1
"12198","Troy","W Kentucky",4,0,0,4
"12199","Troy","Belhaven MS",0,1,1,1
"12200","Troy","Brewton-Parker",0,1,1,1
"12201","Troy","Fort Valley St",0,1,1,1
"12202","Troy","LaGrange",0,1,1,1
"12203","Tulane","Alabama",0,1,1,1
"12204","Tulane","Alabama St",0,1,1,1
"12205","Tulane","Bethune-Cookman",0,1,1,1
"12206","Tulane","Charlotte",0,1,1,1
"12207","Tulane","Chicago St",0,1,1,1
"12208","Tulane","Cincinnati",1,1,0.5,2
"12209","Tulane","Colgate",1,0,0,1
"12210","Tulane","Connecticut",2,0,0,2
"12211","Tulane","East Carolina",1,2,0.666666666666667,3
"12212","Tulane","FL Atlantic",0,1,1,1
"12213","Tulane","Florida Intl",1,0,0,1
"12214","Tulane","Georgia Tech",1,0,0,1
"12215","Tulane","Hofstra",0,2,1,2
"12216","Tulane","Houston",3,2,0.4,5
"12217","Tulane","Jackson St",0,2,1,2
"12218","Tulane","Kansas St",1,0,0,1
"12219","Tulane","Louisiana Tech",1,0,0,1
"12220","Tulane","Loyola-Chicago",0,2,1,2
"12221","Tulane","Marshall",0,2,1,2
"12222","Tulane","Memphis",2,1,0.333333333333333,3
"12223","Tulane","Middle Tenn St",1,0,0,1
"12224","Tulane","Mississippi St",0,1,1,1
"12225","Tulane","MS Valley St",0,1,1,1
"12226","Tulane","Navy",0,1,1,1
"12227","Tulane","Nebraska",1,0,0,1
"12228","Tulane","NE Omaha",0,1,1,1
"12229","Tulane","Nicholls St",0,1,1,1
"12230","Tulane","NJIT",0,1,1,1
"12231","Tulane","N Kentucky",1,0,0,1
"12232","Tulane","Northeastern",0,1,1,1
"12233","Tulane","North Texas",0,2,1,2
"12234","Tulane","Old Dominion",1,0,0,1
"12235","Tulane","Pepperdine",0,1,1,1
"12236","Tulane","Rice",0,3,1,3
"12237","Tulane","San Diego",1,0,0,1
"12238","Tulane","Savannah St",0,1,1,1
"12239","Tulane","SE Louisiana",0,1,1,1
"12240","Tulane","SE Missouri St",1,0,0,1
"12241","Tulane","SMU",2,1,0.333333333333333,3
"12242","Tulane","Southern Miss",3,0,0,3
"12243","Tulane","Southern Univ",0,3,1,3
"12244","Tulane","South Florida",0,2,1,2
"12245","Tulane","St John's",1,0,0,1
"12246","Tulane","Temple",2,0,0,2
"12247","Tulane","Tennessee Tech",0,1,1,1
"12248","Tulane","Texas St",1,0,0,1
"12249","Tulane","Tulsa",5,1,0.166666666666667,6
"12250","Tulane","TX Pan American",0,1,1,1
"12251","Tulane","UAB",1,1,0.5,2
"12252","Tulane","UCF",3,0,0,3
"12253","Tulane","UTEP",3,0,0,3
"12254","Tulane","UT San Antonio",0,1,1,1
"12255","Tulane","Wake Forest",2,0,0,2
"12256","Tulane","Washington",2,0,0,2
"12257","Tulane","Wofford",0,1,1,1
"12258","Tulane","Cedarville",0,1,1,1
"12259","Tulane","Southern N.O.",0,1,1,1
"12260","Tulsa","Ark Little Rock",1,2,0.666666666666667,3
"12261","Tulsa","Auburn",0,1,1,1
"12262","Tulsa","Buffalo",0,1,1,1
"12263","Tulsa","Charlotte",1,0,0,1
"12264","Tulsa","Cincinnati",1,0,0,1
"12265","Tulsa","Connecticut",2,1,0.333333333333333,3
"12266","Tulsa","Creighton",2,1,0.333333333333333,3
"12267","Tulsa","CS Fullerton",0,1,1,1
"12268","Tulsa","CS Northridge",1,0,0,1
"12269","Tulsa","East Carolina",1,3,0.75,4
"12270","Tulsa","FL Atlantic",0,1,1,1
"12271","Tulsa","Florida Intl",0,1,1,1
"12272","Tulsa","Florida St",1,0,0,1
"12273","Tulsa","Houston",0,5,1,5
"12274","Tulsa","Indiana St",0,1,1,1
"12275","Tulsa","Jackson St",0,1,1,1
"12276","Tulsa","Louisiana Tech",1,1,0.5,2
"12277","Tulsa","Marshall",1,1,0.5,2
"12278","Tulsa","Maryland",1,0,0,1
"12279","Tulsa","Memphis",1,2,0.666666666666667,3
"12280","Tulsa","Middle Tenn St",0,2,1,2
"12281","Tulsa","Missouri St",1,2,0.666666666666667,3
"12282","Tulsa","N Kentucky",0,1,1,1
"12283","Tulsa","North Texas",0,2,1,2
"12284","Tulsa","Oklahoma",2,0,0,2
"12285","Tulsa","Oklahoma St",1,0,0,1
"12286","Tulsa","Old Dominion",0,1,1,1
"12287","Tulsa","Oral Roberts",2,1,0.333333333333333,3
"12288","Tulsa","Rice",0,3,1,3
"12289","Tulsa","San Diego",0,1,1,1
"12290","Tulsa","SF Austin",1,0,0,1
"12291","Tulsa","SMU",3,1,0.25,4
"12292","Tulsa","Southern Miss",1,1,0.5,2
"12293","Tulsa","South Florida",0,2,1,2
"12294","Tulsa","TCU",2,1,0.333333333333333,3
"12295","Tulsa","Temple",0,2,1,2
"12296","Tulsa","Tulane",1,5,0.833333333333333,6
"12297","Tulsa","TX Southern",0,1,1,1
"12298","Tulsa","UAB",2,0,0,2
"12299","Tulsa","UCF",1,1,0.5,2
"12300","Tulsa","ULL",0,1,1,1
"12301","Tulsa","UTEP",0,3,1,3
"12302","Tulsa","UT San Antonio",0,1,1,1
"12303","Tulsa","Wichita St",3,0,0,3
"12304","Tulsa","WI Green Bay",1,0,0,1
"12305","Tulsa","Abilene Chr",0,1,1,1
"12306","Tulsa","Grand Canyon",0,1,1,1
"12307","Tulsa","Incarnate Word",0,1,1,1
"12308","Tulsa","SE Oklahoma",1,0,0,1
"12309","TX Pan American","Alabama St",1,1,0.5,2
"12310","TX Pan American","Bradley",2,0,0,2
"12311","TX Pan American","Chicago St",1,5,0.833333333333333,6
"12312","TX Pan American","Creighton",1,0,0,1
"12313","TX Pan American","CS Bakersfield",3,2,0.4,5
"12314","TX Pan American","Duquesne",2,0,0,2
"12315","TX Pan American","Edwardsville",1,1,0.5,2
"12316","TX Pan American","E Illinois",1,0,0,1
"12317","TX Pan American","E Michigan",1,0,0,1
"12318","TX Pan American","Houston",3,0,0,3
"12319","TX Pan American","Houston Bap",1,1,0.5,2
"12320","TX Pan American","Idaho",2,0,0,2
"12321","TX Pan American","Iowa",1,0,0,1
"12322","TX Pan American","IPFW",2,0,0,2
"12323","TX Pan American","Kent",1,0,0,1
"12324","TX Pan American","Lamar",0,3,1,3
"12325","TX Pan American","Missouri KC",2,3,0.6,5
"12326","TX Pan American","NE Omaha",1,1,0.5,2
"12327","TX Pan American","New Mexico St",4,0,0,4
"12328","TX Pan American","New Orleans",1,1,0.5,2
"12329","TX Pan American","NJIT",1,1,0.5,2
"12330","TX Pan American","North Dakota",0,1,1,1
"12331","TX Pan American","Oregon St",1,0,0,1
"12332","TX Pan American","Portland",0,1,1,1
"12333","TX Pan American","Sam Houston St",2,0,0,2
"12334","TX Pan American","Seattle",3,1,0.25,4
"12335","TX Pan American","SMU",1,0,0,1
"12336","TX Pan American","St Louis",1,0,0,1
"12337","TX Pan American","TAM C. Christi",1,0,0,1
"12338","TX Pan American","TCU",1,0,0,1
"12339","TX Pan American","Tennessee Tech",0,1,1,1
"12340","TX Pan American","Texas A&M",1,0,0,1
"12341","TX Pan American","Texas St",1,0,0,1
"12342","TX Pan American","Tulane",1,0,0,1
"12343","TX Pan American","Utah",1,0,0,1
"12344","TX Pan American","Utah Valley",6,1,0.142857142857143,7
"12345","TX Pan American","UT Arlington",2,0,0,2
"12346","TX Pan American","UT San Antonio",2,2,0.5,4
"12347","TX Pan American","Grand Canyon",3,1,0.25,4
"12348","TX Pan American","Huston-Tillot",0,1,1,1
"12349","TX Pan American","Our Lady Lake",0,1,1,1
"12350","TX Pan American","Wayland",0,1,1,1
"12351","TX Pan American","TX A&M K'ville",0,1,1,1
"12352","TX Southern","Akron",1,0,0,1
"12353","TX Southern","Alabama A&M",1,5,0.833333333333333,6
"12354","TX Southern","Alabama St",1,6,0.857142857142857,7
"12355","TX Southern","Alcorn St",0,7,1,7
"12356","TX Southern","Ark Pine Bluff",2,4,0.666666666666667,6
"12357","TX Southern","Auburn",1,0,0,1
"12358","TX Southern","Baylor",1,0,0,1
"12359","TX Southern","Boise St",1,0,0,1
"12360","TX Southern","Colorado",1,0,0,1
"12361","TX Southern","CS Fullerton",2,0,0,2
"12362","TX Southern","E Washington",1,0,0,1
"12363","TX Southern","Florida",1,0,0,1
"12364","TX Southern","Florida Intl",2,0,0,2
"12365","TX Southern","Gonzaga",1,0,0,1
"12366","TX Southern","Grambling",0,7,1,7
"12367","TX Southern","Houston",1,0,0,1
"12368","TX Southern","Howard",0,1,1,1
"12369","TX Southern","Indiana",1,0,0,1
"12370","TX Southern","Jackson St",2,4,0.666666666666667,6
"12371","TX Southern","Kansas St",1,1,0.5,2
"12372","TX Southern","Lamar",0,1,1,1
"12373","TX Southern","Lehigh",1,0,0,1
"12374","TX Southern","Miami FL",1,0,0,1
"12375","TX Southern","Michigan St",1,1,0.5,2
"12376","TX Southern","Middle Tenn St",1,0,0,1
"12377","TX Southern","MS Valley St",0,6,1,6
"12378","TX Southern","New Mexico St",1,0,0,1
"12379","TX Southern","Norfolk St",1,1,0.5,2
"12380","TX Southern","Northwestern",1,0,0,1
"12381","TX Southern","Oakland",1,0,0,1
"12382","TX Southern","Prairie View",2,6,0.75,8
"12383","TX Southern","San Diego St",1,0,0,1
"12384","TX Southern","SMU",1,0,0,1
"12385","TX Southern","Southern Univ",2,5,0.714285714285714,7
"12386","TX Southern","Stanford",1,0,0,1
"12387","TX Southern","TCU",1,0,0,1
"12388","TX Southern","Temple",0,1,1,1
"12389","TX Southern","Tennessee",1,0,0,1
"12390","TX Southern","Texas Tech",1,0,0,1
"12391","TX Southern","Tulsa",1,0,0,1
"12392","TX Southern","ULL",0,1,1,1
"12393","TX Southern","Wiley",0,1,1,1
"12394","UAB","Alabama A&M",0,1,1,1
"12395","UAB","Charlotte",1,2,0.666666666666667,3
"12396","UAB","Chattanooga",1,1,0.5,2
"12397","UAB","Creighton",1,0,0,1
"12398","UAB","Dayton",1,0,0,1
"12399","UAB","East Carolina",3,0,0,3
"12400","UAB","FL Atlantic",2,1,0.333333333333333,3
"12401","UAB","Florida",1,0,0,1
"12402","UAB","Florida A&M",0,1,1,1
"12403","UAB","Florida Intl",2,1,0.333333333333333,3
"12404","UAB","Ga Southern",0,2,1,2
"12405","UAB","Houston",1,0,0,1
"12406","UAB","Illinois St",2,0,0,2
"12407","UAB","Jackson St",0,1,1,1
"12408","UAB","Louisiana Tech",2,2,0.5,4
"12409","UAB","LSU",2,0,0,2
"12410","UAB","Marshall",0,4,1,4
"12411","UAB","Memphis",2,0,0,2
"12412","UAB","Middle Tenn St",3,0,0,3
"12413","UAB","Morehead St",0,1,1,1
"12414","UAB","Navy",0,1,1,1
"12415","UAB","Nebraska",0,1,1,1
"12416","UAB","New Mexico",1,0,0,1
"12417","UAB","North Carolina",2,1,0.333333333333333,3
"12418","UAB","Northeastern",0,2,1,2
"12419","UAB","North Texas",2,0,0,2
"12420","UAB","Old Dominion",0,2,1,2
"12421","UAB","Prairie View",0,1,1,1
"12422","UAB","Rice",1,2,0.666666666666667,3
"12423","UAB","Rutgers",1,1,0.5,2
"12424","UAB","SMU",0,1,1,1
"12425","UAB","South Alabama",0,1,1,1
"12426","UAB","Southern Miss",2,3,0.6,5
"12427","UAB","South Florida",1,0,0,1
"12428","UAB","TCU",1,0,0,1
"12429","UAB","Temple",1,0,0,1
"12430","UAB","Troy",0,2,1,2
"12431","UAB","Tulane",1,1,0.5,2
"12432","UAB","Tulsa",0,2,1,2
"12433","UAB","UCF",2,0,0,2
"12434","UAB","UCLA",1,0,0,1
"12435","UAB","ULM",1,1,0.5,2
"12436","UAB","UNC Asheville",0,1,1,1
"12437","UAB","UTEP",2,1,0.333333333333333,3
"12438","UAB","UT San Antonio",0,2,1,2
"12439","UAB","Wisconsin",1,0,0,1
"12440","UAB","W Kentucky",0,2,1,2
"12441","UAB","Columbus St",0,1,1,1
"12442","UAB","Newberry",0,1,1,1
"12443","UAB","Young Harris",0,1,1,1
"12444","UAB","MTSU",0,3,1,3
"12445","UC Davis","Air Force",0,2,1,2
"12446","UC Davis","Cal Poly SLO",1,5,0.833333333333333,6
"12447","UC Davis","CS Fullerton",2,4,0.666666666666667,6
"12448","UC Davis","CS Northridge",1,6,0.857142857142857,7
"12449","UC Davis","CS Sacramento",1,1,0.5,2
"12450","UC Davis","Edwardsville",0,1,1,1
"12451","UC Davis","E Illinois",0,2,1,2
"12452","UC Davis","E Washington",0,1,1,1
"12453","UC Davis","Furman",1,1,0.5,2
"12454","UC Davis","Hawaii",4,3,0.428571428571429,7
"12455","UC Davis","Idaho",3,0,0,3
"12456","UC Davis","Long Beach St",4,2,0.333333333333333,6
"12457","UC Davis","Loyola-Chicago",0,1,1,1
"12458","UC Davis","N Colorado",0,2,1,2
"12459","UC Davis","Nevada",2,0,0,2
"12460","UC Davis","Nicholls St",0,1,1,1
"12461","UC Davis","Northern Arizona",1,0,0,1
"12462","UC Davis","Oklahoma St",1,0,0,1
"12463","UC Davis","Pacific",2,0,0,2
"12464","UC Davis","Portland",1,0,0,1
"12465","UC Davis","Portland St",1,0,0,1
"12466","UC Davis","San Jose St",2,1,0.333333333333333,3
"12467","UC Davis","Santa Barbara",4,2,0.333333333333333,6
"12468","UC Davis","Seattle",2,0,0,2
"12469","UC Davis","S Illinois",0,1,1,1
"12470","UC Davis","Stanford",2,0,0,2
"12471","UC Davis","UC Irvine",4,2,0.333333333333333,6
"12472","UC Davis","UC Riverside",2,4,0.666666666666667,6
"12473","UC Davis","Utah",1,0,0,1
"12474","UC Davis","Utah St",1,1,0.5,2
"12475","UC Davis","Utah Valley",0,1,1,1
"12476","UC Davis","Washington St",1,0,0,1
"12477","UC Davis","Holy Names",0,2,1,2
"12478","UC Davis","Simpson CA",0,1,1,1
"12479","UC Davis","Cal Maritime",0,1,1,1
"12480","UCF","Alabama St",0,1,1,1
"12481","UCF","Belmont",0,1,1,1
"12482","UCF","Bethune-Cookman",0,3,1,3
"12483","UCF","Cincinnati",5,0,0,5
"12484","UCF","Connecticut",3,0,0,3
"12485","UCF","Davidson",1,0,0,1
"12486","UCF","Detroit",0,1,1,1
"12487","UCF","East Carolina",4,1,0.2,5
"12488","UCF","FL Atlantic",2,0,0,2
"12489","UCF","Florida",1,0,0,1
"12490","UCF","Florida A&M",0,1,1,1
"12491","UCF","Florida St",2,0,0,2
"12492","UCF","Ga Southern",0,1,1,1
"12493","UCF","Houston",1,4,0.8,5
"12494","UCF","Howard",0,2,1,2
"12495","UCF","IL Chicago",1,0,0,1
"12496","UCF","Jacksonville",0,1,1,1
"12497","UCF","Louisville",2,0,0,2
"12498","UCF","Marshall",2,0,0,2
"12499","UCF","Memphis",6,0,0,6
"12500","UCF","Miami FL",1,1,0.5,2
"12501","UCF","Middle Tenn St",1,0,0,1
"12502","UCF","Old Dominion",0,1,1,1
"12503","UCF","Rice",0,1,1,1
"12504","UCF","Rutgers",1,1,0.5,2
"12505","UCF","Savannah St",0,1,1,1
"12506","UCF","SC Upstate",0,1,1,1
"12507","UCF","SE Louisiana",0,1,1,1
"12508","UCF","SMU",4,1,0.2,5
"12509","UCF","Southern Miss",1,1,0.5,2
"12510","UCF","South Florida",3,3,0.5,6
"12511","UCF","Stetson",0,3,1,3
"12512","UCF","Temple",3,2,0.4,5
"12513","UCF","Tulane",0,3,1,3
"12514","UCF","Tulsa",1,1,0.5,2
"12515","UCF","UAB",0,2,1,2
"12516","UCF","UTEP",1,0,0,1
"12517","UCF","Valparaiso",1,1,0.5,2
"12518","UCF","Eckerd",0,1,1,1
"12519","UCF","Rio Grande",0,1,1,1
"12520","UCF","Tampa",0,1,1,1
"12521","UC Irvine","Arizona",1,0,0,1
"12522","UC Irvine","Arizona St",1,0,0,1
"12523","UC Irvine","Boston Univ",1,0,0,1
"12524","UC Irvine","Bradley",0,1,1,1
"12525","UC Irvine","California",1,0,0,1
"12526","UC Irvine","Cal Poly SLO",2,5,0.714285714285714,7
"12527","UC Irvine","CS Fullerton",0,6,1,6
"12528","UC Irvine","CS Northridge",2,4,0.666666666666667,6
"12529","UC Irvine","CS Sacramento",0,2,1,2
"12530","UC Irvine","Denver",0,1,1,1
"12531","UC Irvine","E Washington",0,2,1,2
"12532","UC Irvine","Fresno St",2,1,0.333333333333333,3
"12533","UC Irvine","Hawaii",2,5,0.714285714285714,7
"12534","UC Irvine","Liberty",0,1,1,1
"12535","UC Irvine","Long Beach St",2,4,0.666666666666667,6
"12536","UC Irvine","Long Island",0,1,1,1
"12537","UC Irvine","Loy Marymount",0,1,1,1
"12538","UC Irvine","LSU",1,0,0,1
"12539","UC Irvine","Morgan St",1,1,0.5,2
"12540","UC Irvine","Nevada",0,1,1,1
"12541","UC Irvine","New Mexico St",1,0,0,1
"12542","UC Irvine","Oregon",2,0,0,2
"12543","UC Irvine","Pacific",2,2,0.5,4
"12544","UC Irvine","Pepperdine",2,0,0,2
"12545","UC Irvine","Sam Houston St",1,0,0,1
"12546","UC Irvine","Santa Barbara",3,4,0.571428571428571,7
"12547","UC Irvine","Southern Miss",1,0,0,1
"12548","UC Irvine","St Mary's CA",1,0,0,1
"12549","UC Irvine","UC Davis",2,4,0.666666666666667,6
"12550","UC Irvine","UCLA",1,0,0,1
"12551","UC Irvine","UC Riverside",2,6,0.75,8
"12552","UC Irvine","UNLV",1,0,0,1
"12553","UC Irvine","USC",0,1,1,1
"12554","UC Irvine","UT Arlington",1,1,0.5,2
"12555","UC Irvine","Washington",0,1,1,1
"12556","UC Irvine","Weber St",1,0,0,1
"12557","UC Irvine","WI Green Bay",0,1,1,1
"12558","UC Irvine","Pacifica",0,1,1,1
"12559","UC Irvine","San Diego Chr",0,1,1,1
"12560","UC Irvine","Chapman",0,1,1,1
"12561","UC Irvine","Hampden-Sydney",0,1,1,1
"12562","UCLA","Alabama",1,1,0.5,2
"12563","UCLA","Arizona",3,3,0.5,6
"12564","UCLA","Arizona St",2,2,0.5,4
"12565","UCLA","California",2,4,0.666666666666667,6
"12566","UCLA","Cal Poly SLO",1,0,0,1
"12567","UCLA","Chattanooga",0,1,1,1
"12568","UCLA","Coastal Car",0,1,1,1
"12569","UCLA","Colorado",1,4,0.8,5
"12570","UCLA","CS Fullerton",0,1,1,1
"12571","UCLA","CS Northridge",0,1,1,1
"12572","UCLA","CS Sacramento",0,1,1,1
"12573","UCLA","Drexel",0,1,1,1
"12574","UCLA","Duke",1,0,0,1
"12575","UCLA","Fresno St",0,1,1,1
"12576","UCLA","Georgetown",1,0,0,1
"12577","UCLA","Georgia",0,1,1,1
"12578","UCLA","Gonzaga",1,0,0,1
"12579","UCLA","Indiana St",0,1,1,1
"12580","UCLA","James Madison",0,1,1,1
"12581","UCLA","Kentucky",1,0,0,1
"12582","UCLA","Long Beach St",0,2,1,2
"12583","UCLA","Missouri",1,1,0.5,2
"12584","UCLA","Montana St",0,1,1,1
"12585","UCLA","Morehead St",0,1,1,1
"12586","UCLA","Nevada",0,1,1,1
"12587","UCLA","Nicholls St",0,1,1,1
"12588","UCLA","North Carolina",1,0,0,1
"12589","UCLA","Northwestern",0,1,1,1
"12590","UCLA","Oakland",0,1,1,1
"12591","UCLA","Oklahoma",1,0,0,1
"12592","UCLA","Oregon",3,3,0.5,6
"12593","UCLA","Oregon St",2,3,0.6,5
"12594","UCLA","Prairie View",0,2,1,2
"12595","UCLA","San Diego",0,1,1,1
"12596","UCLA","San Diego St",1,0,0,1
"12597","UCLA","Santa Barbara",0,1,1,1
"12598","UCLA","Stanford",1,6,0.857142857142857,7
"12599","UCLA","Texas",0,1,1,1
"12600","UCLA","UAB",0,1,1,1
"12601","UCLA","UC Irvine",0,1,1,1
"12602","UCLA","UC Riverside",0,1,1,1
"12603","UCLA","USC",1,6,0.857142857142857,7
"12604","UCLA","Utah",2,3,0.6,5
"12605","UCLA","Washington",0,4,1,4
"12606","UCLA","Washington St",2,2,0.5,4
"12607","UCLA","Weber St",0,1,1,1
"12608","UC Riverside","Air Force",2,0,0,2
"12609","UC Riverside","Cal Poly SLO",4,2,0.333333333333333,6
"12610","UC Riverside","CS Bakersfield",0,1,1,1
"12611","UC Riverside","CS Fullerton",3,3,0.5,6
"12612","UC Riverside","CS Northridge",3,3,0.5,6
"12613","UC Riverside","CS Sacramento",2,0,0,2
"12614","UC Riverside","DePaul",1,0,0,1
"12615","UC Riverside","Fresno St",1,0,0,1
"12616","UC Riverside","Hawaii",5,1,0.166666666666667,6
"12617","UC Riverside","Houston Bap",0,1,1,1
"12618","UC Riverside","IL Chicago",1,1,0.5,2
"12619","UC Riverside","Long Beach St",6,0,0,6
"12620","UC Riverside","Loy Marymount",2,0,0,2
"12621","UC Riverside","Montana St",0,1,1,1
"12622","UC Riverside","Morgan St",0,1,1,1
"12623","UC Riverside","N Colorado",1,1,0.5,2
"12624","UC Riverside","N Illinois",2,0,0,2
"12625","UC Riverside","Northeastern",1,0,0,1
"12626","UC Riverside","North Texas",1,0,0,1
"12627","UC Riverside","Pacific",2,0,0,2
"12628","UC Riverside","Pepperdine",2,0,0,2
"12629","UC Riverside","Portland St",1,1,0.5,2
"12630","UC Riverside","San Diego St",2,0,0,2
"12631","UC Riverside","Santa Barbara",4,2,0.333333333333333,6
"12632","UC Riverside","Seattle",1,0,0,1
"12633","UC Riverside","Southern Utah",0,1,1,1
"12634","UC Riverside","Texas St",1,0,0,1
"12635","UC Riverside","UC Davis",4,2,0.333333333333333,6
"12636","UC Riverside","UC Irvine",6,2,0.25,8
"12637","UC Riverside","UCLA",1,0,0,1
"12638","UC Riverside","USC",1,0,0,1
"12639","UC Riverside","Utah",1,0,0,1
"12640","UC Riverside","Abilene Chr",0,1,1,1
"12641","UC Riverside","Grand Canyon",1,0,0,1
"12642","UC Riverside","La Verne",0,1,1,1
"12643","UC Riverside","St Katherine",0,1,1,1
"12644","UC Riverside","Waldorf",0,1,1,1
"12645","UC Riverside","UC San Diego",0,1,1,1
"12646","ULL","Appalachian St",0,2,1,2
"12647","ULL","Arkansas",1,0,0,1
"12648","ULL","Arkansas St",1,5,0.833333333333333,6
"12649","ULL","Ark Little Rock",2,4,0.666666666666667,6
"12650","ULL","Auburn",1,0,0,1
"12651","ULL","Baylor",1,0,0,1
"12652","ULL","Boise St",1,0,0,1
"12653","ULL","Coastal Car",0,1,1,1
"12654","ULL","Duquesne",0,1,1,1
"12655","ULL","FL Atlantic",1,1,0.5,2
"12656","ULL","Florida Intl",2,0,0,2
"12657","ULL","Ga Southern",1,1,0.5,2
"12658","ULL","Georgia St",5,1,0.166666666666667,6
"12659","ULL","Houston",1,1,0.5,2
"12660","ULL","Jackson St",1,1,0.5,2
"12661","ULL","Lamar",0,1,1,1
"12662","ULL","Louisiana Tech",0,2,1,2
"12663","ULL","Louisville",1,0,0,1
"12664","ULL","McNeese St",2,1,0.333333333333333,3
"12665","ULL","Michigan St",1,0,0,1
"12666","ULL","Middle Tenn St",2,0,0,2
"12667","ULL","New Mexico St",1,0,0,1
"12668","ULL","North Texas",0,2,1,2
"12669","ULL","Northwestern LA",1,1,0.5,2
"12670","ULL","Oakland",0,2,1,2
"12671","ULL","Oral Roberts",0,1,1,1
"12672","ULL","Robert Morris",1,0,0,1
"12673","ULL","South Alabama",5,1,0.166666666666667,6
"12674","ULL","Texas St",0,5,1,5
"12675","ULL","Troy",1,5,0.833333333333333,6
"12676","ULL","Tulsa",1,0,0,1
"12677","ULL","TX Southern",1,0,0,1
"12678","ULL","ULM",3,3,0.5,6
"12679","ULL","UT Arlington",1,4,0.8,5
"12680","ULL","WI Milwaukee",1,0,0,1
"12681","ULL","W Kentucky",4,1,0.2,5
"12682","ULL","Centenary",0,2,1,2
"12683","ULL","Cent Methodist",0,1,1,1
"12684","ULL","Louisiana Col",0,2,1,2
"12685","ULL","Milligan",0,1,1,1
"12686","ULM","Appalachian St",1,1,0.5,2
"12687","ULM","Arkansas St",4,2,0.333333333333333,6
"12688","ULM","Ark Little Rock",2,4,0.666666666666667,6
"12689","ULM","Coastal Car",1,0,0,1
"12690","ULM","FL Atlantic",1,1,0.5,2
"12691","ULM","Florida",1,0,0,1
"12692","ULM","Florida Intl",2,0,0,2
"12693","ULM","Florida St",1,0,0,1
"12694","ULM","Ga Southern",2,1,0.333333333333333,3
"12695","ULM","Georgia St",4,0,0,4
"12696","ULM","Kansas",1,0,0,1
"12697","ULM","Louisiana Tech",2,0,0,2
"12698","ULM","LSU",1,0,0,1
"12699","ULM","Middle Tenn St",2,0,0,2
"12700","ULM","Mississippi",1,0,0,1
"12701","ULM","New Mexico",1,0,0,1
"12702","ULM","North Texas",0,2,1,2
"12703","ULM","Northwestern LA",0,2,1,2
"12704","ULM","Ohio St",1,0,0,1
"12705","ULM","Oklahoma",1,0,0,1
"12706","ULM","Robert Morris",1,0,0,1
"12707","ULM","Samford",1,1,0.5,2
"12708","ULM","SE Louisiana",0,1,1,1
"12709","ULM","South Alabama",2,5,0.714285714285714,7
"12710","ULM","Southern Univ",1,0,0,1
"12711","ULM","Texas St",2,2,0.5,4
"12712","ULM","Troy",3,3,0.5,6
"12713","ULM","UAB",1,1,0.5,2
"12714","ULM","ULL",3,3,0.5,6
"12715","ULM","UT Arlington",4,1,0.2,5
"12716","ULM","W Kentucky",4,0,0,4
"12717","ULM","Central Bap",0,1,1,1
"12718","ULM","Champion Bap",0,1,1,1
"12719","ULM","Louisiana Col",0,1,1,1
"12720","ULM","Thomas GA",0,1,1,1
"12721","ULM","LSU-Alexandria",0,1,1,1
"12722","UNC Asheville","Akron",1,0,0,1
"12723","UNC Asheville","Campbell",0,4,1,4
"12724","UNC Asheville","Charleston So",3,2,0.4,5
"12725","UNC Asheville","Charlotte",3,0,0,3
"12726","UNC Asheville","Coastal Car",4,3,0.428571428571429,7
"12727","UNC Asheville","Col Charleston",0,1,1,1
"12728","UNC Asheville","Duke",1,0,0,1
"12729","UNC Asheville","East Carolina",1,1,0.5,2
"12730","UNC Asheville","ETSU",1,0,0,1
"12731","UNC Asheville","Gardner Webb",2,4,0.666666666666667,6
"12732","UNC Asheville","High Point",3,1,0.25,4
"12733","UNC Asheville","Jacksonville St",2,0,0,2
"12734","UNC Asheville","Kentucky",1,0,0,1
"12735","UNC Asheville","Liberty",0,5,1,5
"12736","UNC Asheville","Longwood",0,4,1,4
"12737","UNC Asheville","NC State",1,0,0,1
"12738","UNC Asheville","Norfolk St",1,0,0,1
"12739","UNC Asheville","Northeastern",0,1,1,1
"12740","UNC Asheville","Ohio",1,0,0,1
"12741","UNC Asheville","Ohio St",1,0,0,1
"12742","UNC Asheville","Presbyterian",2,3,0.6,5
"12743","UNC Asheville","Providence",1,0,0,1
"12744","UNC Asheville","Radford",2,3,0.6,5
"12745","UNC Asheville","Rhode Island",1,0,0,1
"12746","UNC Asheville","SC Upstate",1,1,0.5,2
"12747","UNC Asheville","South Carolina",1,0,0,1
"12748","UNC Asheville","St John's",0,1,1,1
"12749","UNC Asheville","Tennessee",1,0,0,1
"12750","UNC Asheville","UAB",1,0,0,1
"12751","UNC Asheville","UNC Wilmington",1,1,0.5,2
"12752","UNC Asheville","VMI",1,1,0.5,2
"12753","UNC Asheville","Wake Forest",1,0,0,1
"12754","UNC Asheville","W Carolina",2,1,0.333333333333333,3
"12755","UNC Asheville","Winthrop",5,2,0.285714285714286,7
"12756","UNC Asheville","Bluefield VA",0,1,1,1
"12757","UNC Asheville","J&W NC",0,1,1,1
"12758","UNC Asheville","Limestone",0,1,1,1
"12759","UNC Asheville","Montreat And",0,1,1,1
"12760","UNC Asheville","Tusculum",0,1,1,1
"12761","UNC Asheville","VA Intermont",0,1,1,1
"12762","UNC Greensboro","Appalachian St",2,2,0.5,4
"12763","UNC Greensboro","Chattanooga",3,3,0.5,6
"12764","UNC Greensboro","Citadel",2,3,0.6,5
"12765","UNC Greensboro","Col Charleston",1,0,0,1
"12766","UNC Greensboro","Davidson",3,0,0,3
"12767","UNC Greensboro","East Carolina",3,0,0,3
"12768","UNC Greensboro","Elon",5,0,0,5
"12769","UNC Greensboro","E Michigan",1,0,0,1
"12770","UNC Greensboro","ETSU",1,1,0.5,2
"12771","UNC Greensboro","Furman",2,3,0.6,5
"12772","UNC Greensboro","Ga Southern",2,1,0.333333333333333,3
"12773","UNC Greensboro","High Point",2,1,0.333333333333333,3
"12774","UNC Greensboro","Indiana",1,0,0,1
"12775","UNC Greensboro","James Madison",1,1,0.5,2
"12776","UNC Greensboro","Longwood",1,0,0,1
"12777","UNC Greensboro","Louisiana Tech",1,0,0,1
"12778","UNC Greensboro","Mercer",2,0,0,2
"12779","UNC Greensboro","NC A&T",1,0,0,1
"12780","UNC Greensboro","NC State",2,0,0,2
"12781","UNC Greensboro","North Carolina",2,0,0,2
"12782","UNC Greensboro","Presbyterian",1,1,0.5,2
"12783","UNC Greensboro","Rutgers",2,0,0,2
"12784","UNC Greensboro","Samford",3,3,0.5,6
"12785","UNC Greensboro","San Diego",1,0,0,1
"12786","UNC Greensboro","Stetson",0,1,1,1
"12787","UNC Greensboro","UNC Wilmington",2,0,0,2
"12788","UNC Greensboro","Virginia Tech",1,1,0.5,2
"12789","UNC Greensboro","VMI",0,2,1,2
"12790","UNC Greensboro","Wake Forest",2,0,0,2
"12791","UNC Greensboro","W Carolina",6,0,0,6
"12792","UNC Greensboro","Wofford",4,2,0.333333333333333,6
"12793","UNC Greensboro","Youngstown St",1,0,0,1
"12794","UNC Greensboro","Chowan",0,2,1,2
"12795","UNC Greensboro","Claflin",0,1,1,1
"12796","UNC Greensboro","Greensboro",0,2,1,2
"12797","UNC Greensboro","Mars Hill",0,1,1,1
"12798","UNC Wilmington","Campbell",2,1,0.333333333333333,3
"12799","UNC Wilmington","Charleston So",0,1,1,1
"12800","UNC Wilmington","Col Charleston",1,4,0.8,5
"12801","UNC Wilmington","Davidson",2,0,0,2
"12802","UNC Wilmington","Delaware",5,1,0.166666666666667,6
"12803","UNC Wilmington","Drexel",4,1,0.2,5
"12804","UNC Wilmington","East Carolina",0,2,1,2
"12805","UNC Wilmington","Elon",1,1,0.5,2
"12806","UNC Wilmington","George Mason",0,1,1,1
"12807","UNC Wilmington","Georgia St",1,1,0.5,2
"12808","UNC Wilmington","Georgia Tech",1,0,0,1
"12809","UNC Wilmington","Hampton",0,1,1,1
"12810","UNC Wilmington","Hofstra",5,2,0.285714285714286,7
"12811","UNC Wilmington","Iowa",1,0,0,1
"12812","UNC Wilmington","Iowa St",1,0,0,1
"12813","UNC Wilmington","James Madison",4,2,0.333333333333333,6
"12814","UNC Wilmington","Liberty",0,2,1,2
"12815","UNC Wilmington","Louisville",1,0,0,1
"12816","UNC Wilmington","Manhattan",1,0,0,1
"12817","UNC Wilmington","Marshall",2,0,0,2
"12818","UNC Wilmington","Minnesota",1,0,0,1
"12819","UNC Wilmington","North Carolina",1,0,0,1
"12820","UNC Wilmington","Northeastern",3,4,0.571428571428571,7
"12821","UNC Wilmington","Ohio",2,0,0,2
"12822","UNC Wilmington","Old Dominion",3,1,0.25,4
"12823","UNC Wilmington","Purdue",1,0,0,1
"12824","UNC Wilmington","Richmond",1,0,0,1
"12825","UNC Wilmington","SF Austin",1,0,0,1
"12826","UNC Wilmington","Towson",3,3,0.5,6
"12827","UNC Wilmington","UNC Asheville",1,1,0.5,2
"12828","UNC Wilmington","UNC Greensboro",0,2,1,2
"12829","UNC Wilmington","VMI",0,1,1,1
"12830","UNC Wilmington","William & Mary",6,0,0,6
"12831","UNC Wilmington","W Kentucky",1,0,0,1
"12832","UNC Wilmington","Wofford",0,1,1,1
"12833","UNC Wilmington","Campbellsville",0,1,1,1
"12834","UNC Wilmington","St Andrew's",0,1,1,1
"12835","UNC Wilmington","Wingate",0,1,1,1
"12836","UNLV","Air Force",3,3,0.5,6
"12837","UNLV","Albany NY",0,1,1,1
"12838","UNLV","Arizona",1,1,0.5,2
"12839","UNLV","Arizona St",2,0,0,2
"12840","UNLV","Boise St",4,3,0.428571428571429,7
"12841","UNLV","California",0,1,1,1
"12842","UNLV","Canisius",0,1,1,1
"12843","UNLV","Chicago St",0,1,1,1
"12844","UNLV","Colorado St",3,2,0.4,5
"12845","UNLV","CS Bakersfield",0,1,1,1
"12846","UNLV","CS Fullerton",0,1,1,1
"12847","UNLV","Fresno St",2,3,0.6,5
"12848","UNLV","Hawaii",0,1,1,1
"12849","UNLV","Illinois",1,0,0,1
"12850","UNLV","Iowa St",0,1,1,1
"12851","UNLV","Jacksonville St",0,1,1,1
"12852","UNLV","Kansas",1,0,0,1
"12853","UNLV","Mississippi St",0,1,1,1
"12854","UNLV","Morehead St",0,1,1,1
"12855","UNLV","NE Omaha",0,1,1,1
"12856","UNLV","Nevada",3,4,0.571428571428571,7
"12857","UNLV","New Mexico",3,3,0.5,6
"12858","UNLV","North Carolina",1,0,0,1
"12859","UNLV","Northern Arizona",0,1,1,1
"12860","UNLV","Northern Iowa",0,1,1,1
"12861","UNLV","Oregon",1,0,0,1
"12862","UNLV","Portland",0,2,1,2
"12863","UNLV","Portland St",0,1,1,1
"12864","UNLV","Radford",0,1,1,1
"12865","UNLV","Sacred Heart",0,1,1,1
"12866","UNLV","Sam Houston St",0,1,1,1
"12867","UNLV","San Diego St",6,2,0.25,8
"12868","UNLV","San Jose St",0,3,1,3
"12869","UNLV","Santa Barbara",1,0,0,1
"12870","UNLV","Santa Clara",0,1,1,1
"12871","UNLV","South Dakota",0,1,1,1
"12872","UNLV","Southern Utah",0,2,1,2
"12873","UNLV","Stanford",1,0,0,1
"12874","UNLV","Temple",0,1,1,1
"12875","UNLV","TN Martin",0,1,1,1
"12876","UNLV","UC Irvine",0,1,1,1
"12877","UNLV","Utah",1,0,0,1
"12878","UNLV","Utah St",1,3,0.75,4
"12879","UNLV","UTEP",0,1,1,1
"12880","UNLV","Wyoming",1,5,0.833333333333333,6
"12881","UNLV","St Katherine",0,1,1,1
"12882","USC","Akron",1,0,0,1
"12883","USC","Arizona",3,1,0.25,4
"12884","USC","Arizona St",3,2,0.4,5
"12885","USC","Army",1,0,0,1
"12886","USC","Boston College",0,2,1,2
"12887","USC","California",4,2,0.333333333333333,6
"12888","USC","Colorado",6,0,0,6
"12889","USC","Coppin St",0,1,1,1
"12890","USC","CS Bakersfield",0,1,1,1
"12891","USC","CS Fullerton",0,2,1,2
"12892","USC","CS Northridge",0,1,1,1
"12893","USC","Dayton",0,2,1,2
"12894","USC","Drexel",0,1,1,1
"12895","USC","Georgia",1,0,0,1
"12896","USC","Howard",0,1,1,1
"12897","USC","Illinois",1,0,0,1
"12898","USC","Long Beach St",1,1,0.5,2
"12899","USC","Loy Marymount",0,1,1,1
"12900","USC","Marquette",1,0,0,1
"12901","USC","Minnesota",1,0,0,1
"12902","USC","Nebraska",1,0,0,1
"12903","USC","New Mexico",1,1,0.5,2
"12904","USC","Northern Arizona",0,1,1,1
"12905","USC","Oregon",5,0,0,5
"12906","USC","Oregon St",3,2,0.4,5
"12907","USC","Penn St",1,0,0,1
"12908","USC","Portland St",1,0,0,1
"12909","USC","San Diego St",1,0,0,1
"12910","USC","Stanford",4,2,0.333333333333333,6
"12911","USC","Tennessee Tech",0,1,1,1
"12912","USC","Texas",0,1,1,1
"12913","USC","UC Irvine",1,0,0,1
"12914","USC","UCLA",6,1,0.142857142857143,7
"12915","USC","UC Riverside",0,1,1,1
"12916","USC","Utah",4,1,0.2,5
"12917","USC","Utah St",1,1,0.5,2
"12918","USC","Vermont",0,1,1,1
"12919","USC","Villanova",1,0,0,1
"12920","USC","Wake Forest",1,0,0,1
"12921","USC","Washington",2,2,0.5,4
"12922","USC","Washington St",2,2,0.5,4
"12923","USC","Xavier",0,1,1,1
"12924","USC","West Alabama",0,1,1,1
"12925","Utah","Alabama St",0,1,1,1
"12926","Utah","Arizona",7,0,0,7
"12927","Utah","Arizona St",2,4,0.666666666666667,6
"12928","Utah","Ball St",0,2,1,2
"12929","Utah","Boise St",1,1,0.5,2
"12930","Utah","BYU",1,2,0.666666666666667,3
"12931","Utah","California",2,2,0.5,4
"12932","Utah","C Michigan",0,1,1,1
"12933","Utah","Colorado",2,4,0.666666666666667,6
"12934","Utah","CS Northridge",1,0,0,1
"12935","Utah","CS Sacramento",1,0,0,1
"12936","Utah","Fresno St",0,1,1,1
"12937","Utah","Idaho St",0,2,1,2
"12938","Utah","Kansas",1,0,0,1
"12939","Utah","Lamar",0,1,1,1
"12940","Utah","North Dakota",0,1,1,1
"12941","Utah","Oregon",4,1,0.2,5
"12942","Utah","Oregon St",1,3,0.75,4
"12943","Utah","San Diego St",1,0,0,1
"12944","Utah","Savannah St",0,1,1,1
"12945","Utah","S Dakota St",0,1,1,1
"12946","Utah","SMU",1,1,0.5,2
"12947","Utah","Stanford",3,2,0.4,5
"12948","Utah","Texas St",0,2,1,2
"12949","Utah","TX Pan American",0,1,1,1
"12950","Utah","UC Davis",0,1,1,1
"12951","Utah","UCLA",3,2,0.4,5
"12952","Utah","UC Riverside",0,1,1,1
"12953","Utah","UNLV",0,1,1,1
"12954","Utah","USC",1,4,0.8,5
"12955","Utah","Washington",2,4,0.666666666666667,6
"12956","Utah","Washington St",2,3,0.6,5
"12957","Utah","Wichita St",0,1,1,1
"12958","Utah","Wright St",0,1,1,1
"12959","Utah","Carroll MT",0,1,1,1
"12960","Utah","Evergreen St",0,1,1,1
"12961","Utah","Grand Canyon",0,1,1,1
"12962","Utah","St Katherine",0,1,1,1
"12963","Utah St","Air Force",1,2,0.666666666666667,3
"12964","Utah St","Boise St",2,2,0.5,4
"12965","Utah St","BYU",3,0,0,3
"12966","Utah St","Colorado St",1,3,0.75,4
"12967","Utah St","CS Bakersfield",0,1,1,1
"12968","Utah St","Denver",2,0,0,2
"12969","Utah St","Fresno St",2,1,0.333333333333333,3
"12970","Utah St","Idaho",0,2,1,2
"12971","Utah St","Idaho St",0,2,1,2
"12972","Utah St","Illinois St",0,2,1,2
"12973","Utah St","Louisiana Tech",2,0,0,2
"12974","Utah St","Mississippi St",1,1,0.5,2
"12975","Utah St","Nevada",1,3,0.75,4
"12976","Utah St","New Mexico",3,1,0.25,4
"12977","Utah St","New Mexico St",1,1,0.5,2
"12978","Utah St","Nicholls St",0,1,1,1
"12979","Utah St","Pacific",1,0,0,1
"12980","Utah St","San Diego St",4,0,0,4
"12981","Utah St","San Jose St",0,6,1,6
"12982","Utah St","Santa Barbara",0,2,1,2
"12983","Utah St","Santa Clara",0,2,1,2
"12984","Utah St","S Dakota St",1,0,0,1
"12985","Utah St","Seattle",0,2,1,2
"12986","Utah St","S Illinois",0,1,1,1
"12987","Utah St","Southern Utah",0,1,1,1
"12988","Utah St","St Mary's CA",1,0,0,1
"12989","Utah St","TAM C. Christi",0,1,1,1
"12990","Utah St","Texas St",0,2,1,2
"12991","Utah St","Troy",0,1,1,1
"12992","Utah St","UC Davis",1,1,0.5,2
"12993","Utah St","UNLV",3,1,0.25,4
"12994","Utah St","USC",1,1,0.5,2
"12995","Utah St","Utah Valley",0,3,1,3
"12996","Utah St","UT Arlington",2,0,0,2
"12997","Utah St","UT San Antonio",0,2,1,2
"12998","Utah St","Weber St",0,3,1,3
"12999","Utah St","W Illinois",0,1,1,1
"13000","Utah St","Wyoming",3,2,0.4,5
"13001","Utah St","San Diego Chr",0,1,1,1
"13002","Utah St","Wayland",0,1,1,1
"13003","Utah Valley","Arizona",1,0,0,1
"13004","Utah Valley","Arkansas",1,0,0,1
"13005","Utah Valley","Austin Peay",0,1,1,1
"13006","Utah Valley","Chattanooga",1,0,0,1
"13007","Utah Valley","Chicago St",2,4,0.666666666666667,6
"13008","Utah Valley","CS Bakersfield",4,3,0.428571428571429,7
"13009","Utah Valley","CS Sacramento",2,0,0,2
"13010","Utah Valley","E Washington",1,1,0.5,2
"13011","Utah Valley","Houston Bap",1,1,0.5,2
"13012","Utah Valley","Idaho",1,2,0.666666666666667,3
"13013","Utah Valley","Idaho St",0,2,1,2
"13014","Utah Valley","IUPUI",1,1,0.5,2
"13015","Utah Valley","Missouri KC",3,2,0.4,5
"13016","Utah Valley","Montana St",1,0,0,1
"13017","Utah Valley","NC A&T",0,2,1,2
"13018","Utah Valley","NC Central",2,0,0,2
"13019","Utah Valley","N Dakota St",2,0,0,2
"13020","Utah Valley","New Mexico St",3,1,0.25,4
"13021","Utah Valley","NJIT",2,0,0,2
"13022","Utah Valley","Oklahoma St",1,0,0,1
"13023","Utah Valley","Oregon",1,0,0,1
"13024","Utah Valley","Pepperdine",1,1,0.5,2
"13025","Utah Valley","Santa Clara",1,0,0,1
"13026","Utah Valley","SC Upstate",1,0,0,1
"13027","Utah Valley","Seattle",2,2,0.5,4
"13028","Utah Valley","South Dakota",1,1,0.5,2
"13029","Utah Valley","Southern Utah",0,1,1,1
"13030","Utah Valley","Tennessee Tech",1,1,0.5,2
"13031","Utah Valley","Troy",0,2,1,2
"13032","Utah Valley","TX Pan American",1,6,0.857142857142857,7
"13033","Utah Valley","UC Davis",1,0,0,1
"13034","Utah Valley","Utah St",3,0,0,3
"13035","Utah Valley","Washington St",1,0,0,1
"13036","Utah Valley","Weber St",2,1,0.333333333333333,3
"13037","Utah Valley","Grand Canyon",2,2,0.5,4
"13038","Utah Valley","Haskell",0,1,1,1
"13039","Utah Valley","St Katherine",0,2,1,2
"13040","Utah Valley","Bristol",0,1,1,1
"13041","UT Arlington","Appalachian St",1,1,0.5,2
"13042","UT Arlington","Arkansas St",3,1,0.25,4
"13043","UT Arlington","Ark Little Rock",1,3,0.75,4
"13044","UT Arlington","Boise St",2,0,0,2
"13045","UT Arlington","Bradley",0,1,1,1
"13046","UT Arlington","Buffalo",1,0,0,1
"13047","UT Arlington","Cleveland St",1,0,0,1
"13048","UT Arlington","CS Bakersfield",0,2,1,2
"13049","UT Arlington","Denver",2,0,0,2
"13050","UT Arlington","E Michigan",1,0,0,1
"13051","UT Arlington","Ga Southern",1,1,0.5,2
"13052","UT Arlington","Georgia St",4,0,0,4
"13053","UT Arlington","Houston Bap",0,3,1,3
"13054","UT Arlington","Idaho",1,1,0.5,2
"13055","UT Arlington","Kentucky",2,0,0,2
"13056","UT Arlington","Louisiana Tech",2,0,0,2
"13057","UT Arlington","Montana St",1,0,0,1
"13058","UT Arlington","New Mexico St",1,1,0.5,2
"13059","UT Arlington","North Texas",0,1,1,1
"13060","UT Arlington","Oklahoma",2,0,0,2
"13061","UT Arlington","Oklahoma St",1,0,0,1
"13062","UT Arlington","Robert Morris",1,0,0,1
"13063","UT Arlington","Samford",0,2,1,2
"13064","UT Arlington","San Jose St",0,2,1,2
"13065","UT Arlington","Seattle",1,1,0.5,2
"13066","UT Arlington","South Alabama",2,2,0.5,4
"13067","UT Arlington","Texas",3,0,0,3
"13068","UT Arlington","Texas St",1,6,0.857142857142857,7
"13069","UT Arlington","Troy",2,2,0.5,4
"13070","UT Arlington","TX Pan American",0,2,1,2
"13071","UT Arlington","UC Irvine",1,1,0.5,2
"13072","UT Arlington","ULL",4,1,0.2,5
"13073","UT Arlington","ULM",1,4,0.8,5
"13074","UT Arlington","Utah St",0,2,1,2
"13075","UT Arlington","UT San Antonio",0,2,1,2
"13076","UT Arlington","Weber St",0,1,1,1
"13077","UT Arlington","W Kentucky",1,1,0.5,2
"13078","UT Arlington","Dallas Bap",0,1,1,1
"13079","UT Arlington","Grand Canyon",0,1,1,1
"13080","UT Arlington","Howard Payne",0,2,1,2
"13081","UTEP","Alcorn St",0,1,1,1
"13082","UTEP","Arizona",2,0,0,2
"13083","UTEP","Ark Pine Bluff",0,1,1,1
"13084","UTEP","Charlotte",1,1,0.5,2
"13085","UTEP","Clemson",1,0,0,1
"13086","UTEP","Colorado St",2,1,0.333333333333333,3
"13087","UTEP","CS Sacramento",0,1,1,1
"13088","UTEP","Denver",0,1,1,1
"13089","UTEP","East Carolina",0,3,1,3
"13090","UTEP","FL Atlantic",1,1,0.5,2
"13091","UTEP","Florida Intl",0,3,1,3
"13092","UTEP","Houston",1,1,0.5,2
"13093","UTEP","Houston Bap",0,1,1,1
"13094","UTEP","Idaho",0,1,1,1
"13095","UTEP","Iowa",1,0,0,1
"13096","UTEP","Kansas",1,0,0,1
"13097","UTEP","Kent",0,1,1,1
"13098","UTEP","Louisiana Tech",2,1,0.333333333333333,3
"13099","UTEP","Marshall",1,2,0.666666666666667,3
"13100","UTEP","Memphis",1,0,0,1
"13101","UTEP","Middle Tenn St",0,1,1,1
"13102","UTEP","Montana St",0,1,1,1
"13103","UTEP","Nebraska",0,1,1,1
"13104","UTEP","New Mexico St",4,2,0.333333333333333,6
"13105","UTEP","New Orleans",1,0,0,1
"13106","UTEP","North Texas",0,3,1,3
"13107","UTEP","Northwestern LA",0,1,1,1
"13108","UTEP","Oklahoma",1,0,0,1
"13109","UTEP","Old Dominion",0,2,1,2
"13110","UTEP","Oral Roberts",0,1,1,1
"13111","UTEP","Oregon",0,1,1,1
"13112","UTEP","Princeton",0,1,1,1
"13113","UTEP","Rice",0,5,1,5
"13114","UTEP","SE Louisiana",0,1,1,1
"13115","UTEP","SMU",0,2,1,2
"13116","UTEP","Southern Miss",4,1,0.2,5
"13117","UTEP","Tennessee",0,1,1,1
"13118","UTEP","Tulane",0,3,1,3
"13119","UTEP","Tulsa",3,0,0,3
"13120","UTEP","UAB",1,2,0.666666666666667,3
"13121","UTEP","UCF",0,1,1,1
"13122","UTEP","UNLV",1,0,0,1
"13123","UTEP","UT San Antonio",0,4,1,4
"13124","UTEP","Vanderbilt",1,0,0,1
"13125","UTEP","Washington",1,0,0,1
"13126","UTEP","Washington St",0,2,1,2
"13127","UTEP","W Illinois",0,1,1,1
"13128","UTEP","W Kentucky",1,0,0,1
"13129","UTEP","Xavier",0,1,1,1
"13130","UTEP","Incarnate Word",0,1,1,1
"13131","UTEP","Loyola NO",0,1,1,1
"13132","UTEP","West Alabama",0,1,1,1
"13133","UTEP","MTSU",1,1,0.5,2
"13134","UT San Antonio","Arkansas",1,0,0,1
"13135","UT San Antonio","BYU",1,0,0,1
"13136","UT San Antonio","Charlotte",1,1,0.5,2
"13137","UT San Antonio","CS Bakersfield",3,0,0,3
"13138","UT San Antonio","Denver",2,0,0,2
"13139","UT San Antonio","East Carolina",2,0,0,2
"13140","UT San Antonio","FL Atlantic",0,2,1,2
"13141","UT San Antonio","Florida Intl",2,1,0.333333333333333,3
"13142","UT San Antonio","Georgia St",1,0,0,1
"13143","UT San Antonio","Holy Cross",0,1,1,1
"13144","UT San Antonio","Houston",1,0,0,1
"13145","UT San Antonio","Idaho",1,1,0.5,2
"13146","UT San Antonio","Louisiana Tech",5,0,0,5
"13147","UT San Antonio","Loyola-Chicago",1,0,0,1
"13148","UT San Antonio","Marshall",0,2,1,2
"13149","UT San Antonio","Middle Tenn St",1,0,0,1
"13150","UT San Antonio","Mississippi St",1,0,0,1
"13151","UT San Antonio","Morgan St",1,0,0,1
"13152","UT San Antonio","New Mexico St",2,0,0,2
"13153","UT San Antonio","Nicholls St",1,1,0.5,2
"13154","UT San Antonio","Northern Arizona",1,1,0.5,2
"13155","UT San Antonio","North Texas",1,2,0.666666666666667,3
"13156","UT San Antonio","Old Dominion",1,2,0.666666666666667,3
"13157","UT San Antonio","Oregon",1,0,0,1
"13158","UT San Antonio","Rice",2,1,0.333333333333333,3
"13159","UT San Antonio","San Jose St",1,0,0,1
"13160","UT San Antonio","SC Upstate",1,1,0.5,2
"13161","UT San Antonio","Seattle",1,1,0.5,2
"13162","UT San Antonio","Southern Miss",2,1,0.333333333333333,3
"13163","UT San Antonio","Southern Utah",1,0,0,1
"13164","UT San Antonio","TAM C. Christi",0,3,1,3
"13165","UT San Antonio","TCU",1,0,0,1
"13166","UT San Antonio","Texas St",1,2,0.666666666666667,3
"13167","UT San Antonio","Texas Tech",1,0,0,1
"13168","UT San Antonio","Tulane",1,0,0,1
"13169","UT San Antonio","Tulsa",1,0,0,1
"13170","UT San Antonio","TX Pan American",2,2,0.5,4
"13171","UT San Antonio","UAB",2,0,0,2
"13172","UT San Antonio","Utah St",2,0,0,2
"13173","UT San Antonio","UT Arlington",2,0,0,2
"13174","UT San Antonio","UTEP",4,0,0,4
"13175","UT San Antonio","Washington St",1,0,0,1
"13176","UT San Antonio","W Kentucky",1,0,0,1
"13177","UT San Antonio","Cameron",0,2,1,2
"13178","UT San Antonio","Huston-Tillot",0,2,1,2
"13179","UT San Antonio","McMurry",1,0,0,1
"13180","UT San Antonio","MTSU",0,1,1,1
"13181","VA Commonwealth","Alabama",0,1,1,1
"13182","VA Commonwealth","Belmont",0,3,1,3
"13183","VA Commonwealth","Boston College",0,1,1,1
"13184","VA Commonwealth","Butler",0,1,1,1
"13185","VA Commonwealth","Charlotte",0,1,1,1
"13186","VA Commonwealth","Cincinnati",0,1,1,1
"13187","VA Commonwealth","Cleveland St",0,1,1,1
"13188","VA Commonwealth","Davidson",1,2,0.666666666666667,3
"13189","VA Commonwealth","Dayton",1,3,0.75,4
"13190","VA Commonwealth","Duke",1,0,0,1
"13191","VA Commonwealth","Duquesne",0,3,1,3
"13192","VA Commonwealth","E Kentucky",0,1,1,1
"13193","VA Commonwealth","ETSU",0,2,1,2
"13194","VA Commonwealth","F Dickinson",0,1,1,1
"13195","VA Commonwealth","FL Gulf Coast",0,1,1,1
"13196","VA Commonwealth","Florida St",1,0,0,1
"13197","VA Commonwealth","Fordham",0,5,1,5
"13198","VA Commonwealth","George Mason",0,3,1,3
"13199","VA Commonwealth","Georgetown",1,0,0,1
"13200","VA Commonwealth","G Washington",1,5,0.833333333333333,6
"13201","VA Commonwealth","Illinois St",0,2,1,2
"13202","VA Commonwealth","La Salle",2,1,0.333333333333333,3
"13203","VA Commonwealth","Lehigh",0,1,1,1
"13204","VA Commonwealth","Long Beach St",0,1,1,1
"13205","VA Commonwealth","Longwood",0,1,1,1
"13206","VA Commonwealth","Massachusetts",1,2,0.666666666666667,3
"13207","VA Commonwealth","MD E Shore",0,1,1,1
"13208","VA Commonwealth","Memphis",0,1,1,1
"13209","VA Commonwealth","Missouri",1,0,0,1
"13210","VA Commonwealth","Northeastern",0,1,1,1
"13211","VA Commonwealth","Northern Iowa",1,1,0.5,2
"13212","VA Commonwealth","Old Dominion",1,2,0.666666666666667,3
"13213","VA Commonwealth","Oregon",0,1,1,1
"13214","VA Commonwealth","Rhode Island",0,3,1,3
"13215","VA Commonwealth","Richmond",3,5,0.625,8
"13216","VA Commonwealth","St Bonaventure",1,2,0.666666666666667,3
"13217","VA Commonwealth","Stetson",0,1,1,1
"13218","VA Commonwealth","St Joseph's PA",2,2,0.5,4
"13219","VA Commonwealth","St Louis",2,3,0.6,5
"13220","VA Commonwealth","Stony Brook",0,1,1,1
"13221","VA Commonwealth","Temple",1,0,0,1
"13222","VA Commonwealth","Tennessee",0,1,1,1
"13223","VA Commonwealth","Toledo",0,1,1,1
"13224","VA Commonwealth","Villanova",1,0,0,1
"13225","VA Commonwealth","Virginia",1,1,0.5,2
"13226","VA Commonwealth","Virginia Tech",0,1,1,1
"13227","VA Commonwealth","Wichita St",1,0,0,1
"13228","VA Commonwealth","Winthrop",0,2,1,2
"13229","VA Commonwealth","W Kentucky",0,1,1,1
"13230","VA Commonwealth","Wofford",0,1,1,1
"13231","VA Commonwealth","Xavier",0,1,1,1
"13232","Valparaiso","Ark Pine Bluff",0,1,1,1
"13233","Valparaiso","Ball St",0,2,1,2
"13234","Valparaiso","Bethune-Cookman",0,1,1,1
"13235","Valparaiso","Chicago St",0,1,1,1
"13236","Valparaiso","Cleveland St",2,5,0.714285714285714,7
"13237","Valparaiso","Detroit",3,3,0.5,6
"13238","Valparaiso","Drake",0,1,1,1
"13239","Valparaiso","E Kentucky",0,2,1,2
"13240","Valparaiso","ETSU",1,1,0.5,2
"13241","Valparaiso","Evansville",1,0,0,1
"13242","Valparaiso","Ga Southern",0,1,1,1
"13243","Valparaiso","IL Chicago",0,7,1,7
"13244","Valparaiso","Illinois",1,0,0,1
"13245","Valparaiso","IPFW",0,2,1,2
"13246","Valparaiso","IUPUI",0,1,1,1
"13247","Valparaiso","James Madison",0,2,1,2
"13248","Valparaiso","Kent",0,1,1,1
"13249","Valparaiso","Loy Marymount",0,1,1,1
"13250","Valparaiso","Loyola-Chicago",1,1,0.5,2
"13251","Valparaiso","Maine",0,1,1,1
"13252","Valparaiso","Mercer",1,0,0,1
"13253","Valparaiso","Missouri",1,0,0,1
"13254","Valparaiso","Missouri St",0,1,1,1
"13255","Valparaiso","Murray St",0,3,1,3
"13256","Valparaiso","Nebraska",1,0,0,1
"13257","Valparaiso","New Mexico",2,0,0,2
"13258","Valparaiso","N Illinois",0,1,1,1
"13259","Valparaiso","Oakland",3,2,0.4,5
"13260","Valparaiso","Ohio",1,0,0,1
"13261","Valparaiso","Portland",0,1,1,1
"13262","Valparaiso","St Louis",2,0,0,2
"13263","Valparaiso","UCF",1,1,0.5,2
"13264","Valparaiso","WI Green Bay",2,6,0.75,8
"13265","Valparaiso","WI Milwaukee",1,6,0.857142857142857,7
"13266","Valparaiso","Wright St",2,4,0.666666666666667,6
"13267","Valparaiso","Youngstown St",1,5,0.833333333333333,6
"13268","Valparaiso","Cincinnati Chr",0,1,1,1
"13269","Valparaiso","North Park",0,1,1,1
"13270","Valparaiso","Southeastern FL",0,1,1,1
"13271","Valparaiso","Goshen",0,1,1,1
"13272","Valparaiso","IN S Bend",0,1,1,1
"13273","Valparaiso","Trinity IL",0,1,1,1
"13274","Vanderbilt","Alabama",2,2,0.5,4
"13275","Vanderbilt","Alabama A&M",0,1,1,1
"13276","Vanderbilt","Arkansas",3,1,0.25,4
"13277","Vanderbilt","Auburn",0,4,1,4
"13278","Vanderbilt","Austin Peay",0,1,1,1
"13279","Vanderbilt","Baylor",1,0,0,1
"13280","Vanderbilt","Butler",2,0,0,2
"13281","Vanderbilt","Cornell",0,1,1,1
"13282","Vanderbilt","Davidson",1,0,0,1
"13283","Vanderbilt","Florida",3,1,0.25,4
"13284","Vanderbilt","Georgia",2,2,0.5,4
"13285","Vanderbilt","Georgia St",0,1,1,1
"13286","Vanderbilt","Georgia Tech",1,1,0.5,2
"13287","Vanderbilt","Kentucky",4,0,0,4
"13288","Vanderbilt","La Salle",0,1,1,1
"13289","Vanderbilt","Lipscomb",0,2,1,2
"13290","Vanderbilt","Loy Marymount",0,1,1,1
"13291","Vanderbilt","LSU",4,0,0,4
"13292","Vanderbilt","Marist",1,0,0,1
"13293","Vanderbilt","Marshall",0,1,1,1
"13294","Vanderbilt","Middle Tenn St",1,0,0,1
"13295","Vanderbilt","Mississippi",3,1,0.25,4
"13296","Vanderbilt","Mississippi St",2,3,0.6,5
"13297","Vanderbilt","Missouri",2,2,0.5,4
"13298","Vanderbilt","Morgan St",0,1,1,1
"13299","Vanderbilt","Nicholls St",0,1,1,1
"13300","Vanderbilt","Norfolk St",0,1,1,1
"13301","Vanderbilt","Northeastern",0,1,1,1
"13302","Vanderbilt","Oregon",1,0,0,1
"13303","Vanderbilt","Penn",0,1,1,1
"13304","Vanderbilt","Providence",1,0,0,1
"13305","Vanderbilt","Purdue",0,1,1,1
"13306","Vanderbilt","Rutgers",1,0,0,1
"13307","Vanderbilt","South Carolina",1,3,0.75,4
"13308","Vanderbilt","St Louis",1,1,0.5,2
"13309","Vanderbilt","Tennessee",5,2,0.285714285714286,7
"13310","Vanderbilt","Tennessee St",0,1,1,1
"13311","Vanderbilt","Texas",1,0,0,1
"13312","Vanderbilt","Texas A&M",1,3,0.75,4
"13313","Vanderbilt","UTEP",0,1,1,1
"13314","Vanderbilt","Villanova",1,0,0,1
"13315","Vanderbilt","W Carolina",0,1,1,1
"13316","Vanderbilt","William & Mary",0,1,1,1
"13317","Vanderbilt","Xavier",0,1,1,1
"13318","Vanderbilt","Yale",0,1,1,1
"13319","Vanderbilt","Trevecca Naz",0,1,1,1
"13320","Vermont","Albany NY",3,4,0.571428571428571,7
"13321","Vermont","Binghamton",1,5,0.833333333333333,6
"13322","Vermont","Boston Univ",2,0,0,2
"13323","Vermont","Bryant",1,1,0.5,2
"13324","Vermont","Canisius",1,1,0.5,2
"13325","Vermont","Col Charleston",1,0,0,1
"13326","Vermont","Connecticut",1,0,0,1
"13327","Vermont","Dartmouth",0,3,1,3
"13328","Vermont","Duke",1,0,0,1
"13329","Vermont","F Dickinson",0,1,1,1
"13330","Vermont","Hartford",1,5,0.833333333333333,6
"13331","Vermont","Harvard",2,1,0.333333333333333,3
"13332","Vermont","Illinois St",0,1,1,1
"13333","Vermont","Maine",1,5,0.833333333333333,6
"13334","Vermont","MD Baltimore Co",0,2,1,2
"13335","Vermont","New Hampshire",1,6,0.857142857142857,7
"13336","Vermont","Niagara",1,0,0,1
"13337","Vermont","Northeastern",0,1,1,1
"13338","Vermont","Providence",1,0,0,1
"13339","Vermont","Quinnipiac",2,1,0.333333333333333,3
"13340","Vermont","Rhode Island",1,0,0,1
"13341","Vermont","San Francisco",1,0,0,1
"13342","Vermont","Santa Barbara",1,0,0,1
"13343","Vermont","Siena",0,3,1,3
"13344","Vermont","St Joseph's PA",2,0,0,2
"13345","Vermont","St Louis",1,0,0,1
"13346","Vermont","Stony Brook",3,4,0.571428571428571,7
"13347","Vermont","Towson",1,0,0,1
"13348","Vermont","USC",1,0,0,1
"13349","Vermont","Wagner",1,1,0.5,2
"13350","Vermont","Yale",1,2,0.666666666666667,3
"13351","Vermont","Lyndon St",0,1,1,1
"13352","Vermont","MA Lowell",0,4,1,4
"13353","Vermont","Sonoma St",0,1,1,1
"13354","Vermont","UMBC",0,5,1,5
"13355","Vermont","S Vermont",0,1,1,1
"13356","Villanova","Alabama",1,0,0,1
"13357","Villanova","Bucknell",0,1,1,1
"13358","Villanova","Butler",0,4,1,4
"13359","Villanova","Cincinnati",1,0,0,1
"13360","Villanova","Columbia",1,0,0,1
"13361","Villanova","Connecticut",0,1,1,1
"13362","Villanova","Creighton",2,2,0.5,4
"13363","Villanova","Delaware",0,3,1,3
"13364","Villanova","DePaul",0,5,1,5
"13365","Villanova","Georgetown",1,4,0.8,5
"13366","Villanova","Illinois",0,1,1,1
"13367","Villanova","Iowa",0,1,1,1
"13368","Villanova","Kansas",0,1,1,1
"13369","Villanova","Lafayette",0,1,1,1
"13370","Villanova","La Salle",1,2,0.666666666666667,3
"13371","Villanova","Lehigh",0,1,1,1
"13372","Villanova","Louisville",0,1,1,1
"13373","Villanova","Marquette",0,6,1,6
"13374","Villanova","Marshall",0,1,1,1
"13375","Villanova","MD E Shore",0,1,1,1
"13376","Villanova","Michigan",0,1,1,1
"13377","Villanova","Monmouth NJ",0,1,1,1
"13378","Villanova","Mt St Mary's",0,1,1,1
"13379","Villanova","NJIT",0,2,1,2
"13380","Villanova","Notre Dame",1,0,0,1
"13381","Villanova","Penn",0,3,1,3
"13382","Villanova","Pittsburgh",2,0,0,2
"13383","Villanova","Providence",2,5,0.714285714285714,7
"13384","Villanova","Purdue",0,1,1,1
"13385","Villanova","Rider",0,1,1,1
"13386","Villanova","Rutgers",0,1,1,1
"13387","Villanova","Seton Hall",3,3,0.5,6
"13388","Villanova","South Florida",0,2,1,2
"13389","Villanova","St John's",0,5,1,5
"13390","Villanova","St Joseph's PA",0,3,1,3
"13391","Villanova","Syracuse",2,2,0.5,4
"13392","Villanova","Temple",1,2,0.666666666666667,3
"13393","Villanova","Towson",0,1,1,1
"13394","Villanova","USC",0,1,1,1
"13395","Villanova","VA Commonwealth",0,1,1,1
"13396","Villanova","Vanderbilt",0,1,1,1
"13397","Villanova","Xavier",0,5,1,5
"13398","Virginia","Boston College",1,3,0.75,4
"13399","Virginia","Clemson",1,3,0.75,4
"13400","Virginia","Cleveland St",0,1,1,1
"13401","Virginia","Davidson",0,2,1,2
"13402","Virginia","Delaware",1,0,0,1
"13403","Virginia","Duke",2,2,0.5,4
"13404","Virginia","Fairfield",0,1,1,1
"13405","Virginia","Florida St",1,6,0.857142857142857,7
"13406","Virginia","George Mason",1,0,0,1
"13407","Virginia","Georgia Tech",1,3,0.75,4
"13408","Virginia","G Washington",0,1,1,1
"13409","Virginia","Hampton",0,1,1,1
"13410","Virginia","Harvard",0,1,1,1
"13411","Virginia","James Madison",0,2,1,2
"13412","Virginia","Lamar",0,1,1,1
"13413","Virginia","La Salle",0,1,1,1
"13414","Virginia","Liberty",0,1,1,1
"13415","Virginia","Louisville",1,1,0.5,2
"13416","Virginia","Maryland",1,4,0.8,5
"13417","Virginia","Miami FL",1,2,0.666666666666667,3
"13418","Virginia","Missouri St",0,1,1,1
"13419","Virginia","Morgan St",0,1,1,1
"13420","Virginia","MS Valley St",0,1,1,1
"13421","Virginia","Navy",0,1,1,1
"13422","Virginia","NC State",0,4,1,4
"13423","Virginia","Norfolk St",0,2,1,2
"13424","Virginia","North Carolina",2,3,0.6,5
"13425","Virginia","Northern Iowa",0,1,1,1
"13426","Virginia","North Texas",0,1,1,1
"13427","Virginia","Notre Dame",0,3,1,3
"13428","Virginia","Old Dominion",1,0,0,1
"13429","Virginia","Pittsburgh",0,3,1,3
"13430","Virginia","Rutgers",0,1,1,1
"13431","Virginia","S Carolina St",0,1,1,1
"13432","Virginia","Seattle",0,1,1,1
"13433","Virginia","SMU",0,1,1,1
"13434","Virginia","Syracuse",0,2,1,2
"13435","Virginia","Tennessee",1,1,0.5,2
"13436","Virginia","Tennessee St",0,1,1,1
"13437","Virginia","VA Commonwealth",1,1,0.5,2
"13438","Virginia","Virginia Tech",0,6,1,6
"13439","Virginia","Wake Forest",1,3,0.75,4
"13440","Virginia","WI Green Bay",1,1,0.5,2
"13441","Virginia","Wisconsin",1,1,0.5,2
"13442","Virginia","Wofford",0,1,1,1
"13443","Virginia Tech","Alabama A&M",0,1,1,1
"13444","Virginia Tech","Appalachian St",1,1,0.5,2
"13445","Virginia Tech","Boston College",4,0,0,4
"13446","Virginia Tech","Bradley",0,1,1,1
"13447","Virginia Tech","BYU",1,0,0,1
"13448","Virginia Tech","Citadel",0,1,1,1
"13449","Virginia Tech","Clemson",3,1,0.25,4
"13450","Virginia Tech","Colorado St",1,0,0,1
"13451","Virginia Tech","Duke",4,0,0,4
"13452","Virginia Tech","ETSU",0,1,1,1
"13453","Virginia Tech","Florida St",3,1,0.25,4
"13454","Virginia Tech","Furman",0,1,1,1
"13455","Virginia Tech","Ga Southern",1,0,0,1
"13456","Virginia Tech","Georgia Tech",2,2,0.5,4
"13457","Virginia Tech","Iowa",0,1,1,1
"13458","Virginia Tech","Liberty",0,1,1,1
"13459","Virginia Tech","Louisville",1,0,0,1
"13460","Virginia Tech","Maryland",4,0,0,4
"13461","Virginia Tech","MD E Shore",0,2,1,2
"13462","Virginia Tech","Miami FL",6,2,0.25,8
"13463","Virginia Tech","Miami OH",0,1,1,1
"13464","Virginia Tech","Michigan St",1,0,0,1
"13465","Virginia Tech","Morgan St",0,1,1,1
"13466","Virginia Tech","MS Valley St",0,1,1,1
"13467","Virginia Tech","NC State",3,0,0,3
"13468","Virginia Tech","North Carolina",3,0,0,3
"13469","Virginia Tech","Northern Iowa",1,0,0,1
"13470","Virginia Tech","Notre Dame",2,0,0,2
"13471","Virginia Tech","Oklahoma St",0,1,1,1
"13472","Virginia Tech","Penn St",1,0,0,1
"13473","Virginia Tech","Pittsburgh",1,1,0.5,2
"13474","Virginia Tech","Presbyterian",0,1,1,1
"13475","Virginia Tech","Radford",1,1,0.5,2
"13476","Virginia Tech","Rhode Island",0,1,1,1
"13477","Virginia Tech","SC Upstate",1,0,0,1
"13478","Virginia Tech","Seton Hall",1,0,0,1
"13479","Virginia Tech","Syracuse",3,0,0,3
"13480","Virginia Tech","UNC Greensboro",1,1,0.5,2
"13481","Virginia Tech","VA Commonwealth",1,0,0,1
"13482","Virginia Tech","Virginia",6,0,0,6
"13483","Virginia Tech","VMI",0,3,1,3
"13484","Virginia Tech","Wake Forest",3,2,0.4,5
"13485","Virginia Tech","W Carolina",0,1,1,1
"13486","Virginia Tech","West Virginia",2,1,0.333333333333333,3
"13487","Virginia Tech","Winthrop",0,1,1,1
"13488","VMI","Air Force",0,1,1,1
"13489","VMI","Army",2,0,0,2
"13490","VMI","Campbell",2,2,0.5,4
"13491","VMI","Charleston So",1,1,0.5,2
"13492","VMI","Chattanooga",2,0,0,2
"13493","VMI","Citadel",1,4,0.8,5
"13494","VMI","Clemson",1,0,0,1
"13495","VMI","Coastal Car",3,0,0,3
"13496","VMI","East Carolina",1,0,0,1
"13497","VMI","Elon",1,1,0.5,2
"13498","VMI","ETSU",1,1,0.5,2
"13499","VMI","Furman",0,2,1,2
"13500","VMI","Gardner Webb",1,2,0.666666666666667,3
"13501","VMI","G Washington",2,0,0,2
"13502","VMI","High Point",3,1,0.25,4
"13503","VMI","Liberty",1,3,0.75,4
"13504","VMI","Longwood",0,4,1,4
"13505","VMI","Marist",1,1,0.5,2
"13506","VMI","Maryland",1,0,0,1
"13507","VMI","Mercer",3,0,0,3
"13508","VMI","Morgan St",1,0,0,1
"13509","VMI","Navy",1,0,0,1
"13510","VMI","Old Dominion",0,1,1,1
"13511","VMI","Presbyterian",0,2,1,2
"13512","VMI","Radford",1,3,0.75,4
"13513","VMI","Samford",1,1,0.5,2
"13514","VMI","UNC Asheville",1,1,0.5,2
"13515","VMI","UNC Greensboro",2,0,0,2
"13516","VMI","UNC Wilmington",1,0,0,1
"13517","VMI","Virginia Tech",3,0,0,3
"13518","VMI","Wake Forest",1,0,0,1
"13519","VMI","W Carolina",1,1,0.5,2
"13520","VMI","West Virginia",2,0,0,2
"13521","VMI","William & Mary",1,0,0,1
"13522","VMI","Winthrop",1,1,0.5,2
"13523","VMI","Wofford",2,0,0,2
"13524","VMI","Wright St",1,1,0.5,2
"13525","VMI","Bluefield WV",0,1,1,1
"13526","VMI","Bridgewater VA",0,1,1,1
"13527","VMI","VA-Lynchburg",0,1,1,1
"13528","VMI","Washington MD",0,1,1,1
"13529","VMI","Johnson TN",0,1,1,1
"13530","VMI","Mid-Atlantic Chr",0,1,1,1
"13531","Wagner","Albany NY",1,0,0,1
"13532","Wagner","Bryant",3,2,0.4,5
"13533","Wagner","Central Conn",3,5,0.625,8
"13534","Wagner","Cincinnati",1,0,0,1
"13535","Wagner","Columbia",1,0,0,1
"13536","Wagner","Coppin St",0,2,1,2
"13537","Wagner","Delaware St",1,0,0,1
"13538","Wagner","F Dickinson",0,6,1,6
"13539","Wagner","Hofstra",1,1,0.5,2
"13540","Wagner","IL Chicago",1,0,0,1
"13541","Wagner","Lafayette",2,0,0,2
"13542","Wagner","La Salle",1,0,0,1
"13543","Wagner","Long Island",1,6,0.857142857142857,7
"13544","Wagner","Maine",1,0,0,1
"13545","Wagner","Maryland",1,0,0,1
"13546","Wagner","Monmouth NJ",1,3,0.75,4
"13547","Wagner","Mt St Mary's",3,4,0.571428571428571,7
"13548","Wagner","NC Central",0,1,1,1
"13549","Wagner","Penn",0,3,1,3
"13550","Wagner","Penn St",1,0,0,1
"13551","Wagner","Princeton",0,1,1,1
"13552","Wagner","Quinnipiac",1,0,0,1
"13553","Wagner","Rider",2,0,0,2
"13554","Wagner","Robert Morris",5,1,0.166666666666667,6
"13555","Wagner","Sacred Heart",1,4,0.8,5
"13556","Wagner","Santa Clara",1,0,0,1
"13557","Wagner","SMU",0,1,1,1
"13558","Wagner","St Bonaventure",1,0,0,1
"13559","Wagner","Stetson",0,1,1,1
"13560","Wagner","St Francis NY",5,0,0,5
"13561","Wagner","St Francis PA",1,4,0.8,5
"13562","Wagner","St John's",1,0,0,1
"13563","Wagner","Syracuse",1,0,0,1
"13564","Wagner","Temple",1,0,0,1
"13565","Wagner","Vermont",1,1,0.5,2
"13566","Wagner","Chestnut Hill",0,1,1,1
"13567","Wagner","Old Westbury",0,1,1,1
"13568","Wake Forest","Arkansas",1,0,0,1
"13569","Wake Forest","Boston College",3,1,0.25,4
"13570","Wake Forest","Bucknell",0,1,1,1
"13571","Wake Forest","Citadel",0,1,1,1
"13572","Wake Forest","Clemson",3,1,0.25,4
"13573","Wake Forest","Colgate",0,1,1,1
"13574","Wake Forest","Connecticut",1,0,0,1
"13575","Wake Forest","Delaware St",1,0,0,1
"13576","Wake Forest","Duke",5,1,0.166666666666667,6
"13577","Wake Forest","Florida",1,0,0,1
"13578","Wake Forest","Florida St",3,1,0.25,4
"13579","Wake Forest","Furman",0,1,1,1
"13580","Wake Forest","Georgia Tech",4,1,0.2,5
"13581","Wake Forest","High Point",0,1,1,1
"13582","Wake Forest","Iona",2,0,0,2
"13583","Wake Forest","Jacksonville",0,1,1,1
"13584","Wake Forest","Kansas",1,0,0,1
"13585","Wake Forest","Louisville",1,0,0,1
"13586","Wake Forest","Maryland",3,0,0,3
"13587","Wake Forest","Mercer",0,1,1,1
"13588","Wake Forest","Miami FL",1,2,0.666666666666667,3
"13589","Wake Forest","Minnesota",1,0,0,1
"13590","Wake Forest","Mt St Mary's",0,1,1,1
"13591","Wake Forest","NC State",3,3,0.5,6
"13592","Wake Forest","Nebraska",1,0,0,1
"13593","Wake Forest","Nicholls St",0,1,1,1
"13594","Wake Forest","North Carolina",3,1,0.25,4
"13595","Wake Forest","Notre Dame",1,2,0.666666666666667,3
"13596","Wake Forest","Pittsburgh",2,1,0.333333333333333,3
"13597","Wake Forest","Presbyterian",0,1,1,1
"13598","Wake Forest","Princeton",0,1,1,1
"13599","Wake Forest","Radford",0,1,1,1
"13600","Wake Forest","Richmond",1,2,0.666666666666667,3
"13601","Wake Forest","Samford",0,1,1,1
"13602","Wake Forest","Seton Hall",1,0,0,1
"13603","Wake Forest","St Bonaventure",0,1,1,1
"13604","Wake Forest","Syracuse",2,0,0,2
"13605","Wake Forest","Tennessee",1,0,0,1
"13606","Wake Forest","Tulane",0,2,1,2
"13607","Wake Forest","UNC Asheville",0,1,1,1
"13608","Wake Forest","UNC Greensboro",0,2,1,2
"13609","Wake Forest","USC",0,1,1,1
"13610","Wake Forest","Virginia",3,1,0.25,4
"13611","Wake Forest","Virginia Tech",2,3,0.6,5
"13612","Wake Forest","VMI",0,1,1,1
"13613","Wake Forest","William & Mary",0,1,1,1
"13614","Wake Forest","Xavier",1,1,0.5,2
"13615","Washington","Albany NY",1,0,0,1
"13616","Washington","Arizona",4,0,0,4
"13617","Washington","Arizona St",1,3,0.75,4
"13618","Washington","Boston College",1,0,0,1
"13619","Washington","California",4,1,0.2,5
"13620","Washington","Cal Poly SLO",0,1,1,1
"13621","Washington","Colorado",2,3,0.6,5
"13622","Washington","Colorado St",1,0,0,1
"13623","Washington","Connecticut",2,0,0,2
"13624","Washington","CS Fullerton",0,1,1,1
"13625","Washington","E Washington",0,2,1,2
"13626","Washington","Grambling",0,1,1,1
"13627","Washington","Hartford",0,1,1,1
"13628","Washington","Idaho St",0,1,1,1
"13629","Washington","Indiana",1,0,0,1
"13630","Washington","Jackson St",0,1,1,1
"13631","Washington","Long Beach St",0,2,1,2
"13632","Washington","Loyola MD",0,1,1,1
"13633","Washington","Montana",0,1,1,1
"13634","Washington","MS Valley St",0,1,1,1
"13635","Washington","Nevada",1,0,0,1
"13636","Washington","N Illinois",0,1,1,1
"13637","Washington","Ohio St",1,0,0,1
"13638","Washington","Oklahoma",0,1,1,1
"13639","Washington","Oregon",4,2,0.333333333333333,6
"13640","Washington","Oregon St",2,4,0.666666666666667,6
"13641","Washington","Pacific",0,1,1,1
"13642","Washington","San Diego St",1,1,0.5,2
"13643","Washington","San Jose St",0,1,1,1
"13644","Washington","S Carolina St",0,1,1,1
"13645","Washington","Seattle",0,3,1,3
"13646","Washington","Seton Hall",0,1,1,1
"13647","Washington","Stanford",4,2,0.333333333333333,6
"13648","Washington","St Louis",0,1,1,1
"13649","Washington","Stony Brook",1,0,0,1
"13650","Washington","Tulane",0,2,1,2
"13651","Washington","UC Irvine",1,0,0,1
"13652","Washington","UCLA",4,0,0,4
"13653","Washington","USC",2,2,0.5,4
"13654","Washington","Utah",4,2,0.333333333333333,6
"13655","Washington","UTEP",0,1,1,1
"13656","Washington","Washington St",2,4,0.666666666666667,6
"13657","Washington St","Arizona",3,1,0.25,4
"13658","Washington St","Arizona St",3,1,0.25,4
"13659","Washington St","Ark Pine Bluff",0,1,1,1
"13660","Washington St","Buffalo",0,1,1,1
"13661","Washington St","Butler",1,0,0,1
"13662","Washington St","California",5,1,0.166666666666667,6
"13663","Washington St","Colorado",4,1,0.2,5
"13664","Washington St","CS Bakersfield",0,1,1,1
"13665","Washington St","E Washington",0,1,1,1
"13666","Washington St","Fresno St",0,1,1,1
"13667","Washington St","Gonzaga",3,0,0,3
"13668","Washington St","Idaho",1,2,0.666666666666667,3
"13669","Washington St","Idaho St",0,2,1,2
"13670","Washington St","Jackson St",0,1,1,1
"13671","Washington St","Kansas",1,0,0,1
"13672","Washington St","Lamar",0,1,1,1
"13673","Washington St","Missouri St",0,1,1,1
"13674","Washington St","MS Valley St",0,1,1,1
"13675","Washington St","Oregon",5,1,0.166666666666667,6
"13676","Washington St","Oregon St",5,1,0.166666666666667,6
"13677","Washington St","Pepperdine",1,1,0.5,2
"13678","Washington St","Portland",0,1,1,1
"13679","Washington St","Purdue",0,1,1,1
"13680","Washington St","Rice",0,1,1,1
"13681","Washington St","San Jose St",0,1,1,1
"13682","Washington St","Santa Barbara",1,0,0,1
"13683","Washington St","Santa Clara",1,0,0,1
"13684","Washington St","Stanford",5,1,0.166666666666667,6
"13685","Washington St","St Joseph's PA",1,0,0,1
"13686","Washington St","TCU",2,0,0,2
"13687","Washington St","Texas A&M",1,0,0,1
"13688","Washington St","UC Davis",0,1,1,1
"13689","Washington St","UCLA",2,2,0.5,4
"13690","Washington St","USC",2,2,0.5,4
"13691","Washington St","Utah",3,2,0.4,5
"13692","Washington St","Utah Valley",0,1,1,1
"13693","Washington St","UTEP",2,0,0,2
"13694","Washington St","UT San Antonio",0,1,1,1
"13695","Washington St","Washington",4,2,0.333333333333333,6
"13696","Washington St","S Francisco St",0,1,1,1
"13697","W Carolina","Alabama",1,0,0,1
"13698","W Carolina","Appalachian St",1,3,0.75,4
"13699","W Carolina","Austin Peay",1,0,0,1
"13700","W Carolina","Charleston So",1,1,0.5,2
"13701","W Carolina","Chattanooga",4,2,0.333333333333333,6
"13702","W Carolina","Chicago St",0,1,1,1
"13703","W Carolina","Citadel",0,5,1,5
"13704","W Carolina","Cleveland St",1,0,0,1
"13705","W Carolina","Coastal Car",1,1,0.5,2
"13706","W Carolina","Col Charleston",1,0,0,1
"13707","W Carolina","Davidson",3,1,0.25,4
"13708","W Carolina","E Kentucky",1,0,0,1
"13709","W Carolina","Elon",3,2,0.4,5
"13710","W Carolina","ETSU",2,1,0.333333333333333,3
"13711","W Carolina","Furman",1,3,0.75,4
"13712","W Carolina","Ga Southern",1,2,0.666666666666667,3
"13713","W Carolina","Georgetown",1,0,0,1
"13714","W Carolina","Georgia",1,0,0,1
"13715","W Carolina","Georgia St",1,0,0,1
"13716","W Carolina","Howard",0,1,1,1
"13717","W Carolina","Illinois",1,0,0,1
"13718","W Carolina","Kent",1,0,0,1
"13719","W Carolina","Liberty",1,1,0.5,2
"13720","W Carolina","Mercer",0,2,1,2
"13721","W Carolina","Minnesota",1,0,0,1
"13722","W Carolina","Mississippi St",1,0,0,1
"13723","W Carolina","Niagara",0,1,1,1
"13724","W Carolina","Oakland",0,1,1,1
"13725","W Carolina","Oregon",1,0,0,1
"13726","W Carolina","Samford",4,2,0.333333333333333,6
"13727","W Carolina","SC Upstate",1,0,0,1
"13728","W Carolina","Tennessee",1,0,0,1
"13729","W Carolina","UNC Asheville",1,2,0.666666666666667,3
"13730","W Carolina","UNC Greensboro",0,6,1,6
"13731","W Carolina","Vanderbilt",1,0,0,1
"13732","W Carolina","Virginia Tech",1,0,0,1
"13733","W Carolina","VMI",1,1,0.5,2
"13734","W Carolina","Wichita St",1,0,0,1
"13735","W Carolina","W Kentucky",1,0,0,1
"13736","W Carolina","Wofford",5,1,0.166666666666667,6
"13737","W Carolina","Wright St",2,0,0,2
"13738","W Carolina","Hiwassee",0,1,1,1
"13739","W Carolina","Limestone",0,1,1,1
"13740","W Carolina","Milligan",0,1,1,1
"13741","W Carolina","St Catharine",0,1,1,1
"13742","W Carolina","Wittenberg",0,1,1,1
"13743","Weber St","BYU",3,0,0,3
"13744","Weber St","Colorado St",1,0,0,1
"13745","Weber St","CS Sacramento",2,3,0.6,5
"13746","Weber St","Dayton",0,1,1,1
"13747","Weber St","E Washington",2,4,0.666666666666667,6
"13748","Weber St","Idaho",1,1,0.5,2
"13749","Weber St","Idaho St",1,5,0.833333333333333,6
"13750","Weber St","Illinois St",1,0,0,1
"13751","Weber St","LSU",1,0,0,1
"13752","Weber St","Montana",4,3,0.428571428571429,7
"13753","Weber St","Montana St",1,5,0.833333333333333,6
"13754","Weber St","N Colorado",2,4,0.666666666666667,6
"13755","Weber St","Nevada",0,1,1,1
"13756","Weber St","North Dakota",0,6,1,6
"13757","Weber St","Northern Arizona",2,4,0.666666666666667,6
"13758","Weber St","Oklahoma",1,0,0,1
"13759","Weber St","Oral Roberts",0,2,1,2
"13760","Weber St","Portland St",2,3,0.6,5
"13761","Weber St","San Jose St",1,1,0.5,2
"13762","Weber St","Southern Utah",2,4,0.666666666666667,6
"13763","Weber St","UC Irvine",0,1,1,1
"13764","Weber St","UCLA",1,0,0,1
"13765","Weber St","Utah St",3,0,0,3
"13766","Weber St","Utah Valley",1,2,0.666666666666667,3
"13767","Weber St","UT Arlington",1,0,0,1
"13768","Weber St","N New Mexico",0,1,1,1
"13769","Weber St","Presentation",0,1,1,1
"13770","Weber St","St Katherine",0,1,1,1
"13771","Weber St","Bristol",0,1,1,1
"13772","West Virginia","Baylor",6,1,0.142857142857143,7
"13773","West Virginia","Boston College",0,1,1,1
"13774","West Virginia","Col Charleston",0,1,1,1
"13775","West Virginia","Connecticut",0,1,1,1
"13776","West Virginia","Davidson",1,0,0,1
"13777","West Virginia","Duquesne",1,1,0.5,2
"13778","West Virginia","E Kentucky",0,1,1,1
"13779","West Virginia","Ga Southern",0,1,1,1
"13780","West Virginia","George Mason",0,1,1,1
"13781","West Virginia","Gonzaga",2,0,0,2
"13782","West Virginia","Iowa St",5,1,0.166666666666667,6
"13783","West Virginia","Kansas",4,2,0.333333333333333,6
"13784","West Virginia","Kansas St",3,3,0.5,6
"13785","West Virginia","Lafayette",0,1,1,1
"13786","West Virginia","Loyola MD",0,1,1,1
"13787","West Virginia","LSU",1,0,0,1
"13788","West Virginia","Marist",0,1,1,1
"13789","West Virginia","Marshall",0,3,1,3
"13790","West Virginia","Michigan",1,0,0,1
"13791","West Virginia","Missouri",1,0,0,1
"13792","West Virginia","Monmouth NJ",0,1,1,1
"13793","West Virginia","Mt St Mary's",0,1,1,1
"13794","West Virginia","NC State",0,1,1,1
"13795","West Virginia","N Kentucky",0,1,1,1
"13796","West Virginia","Oakland",0,1,1,1
"13797","West Virginia","Oklahoma",5,2,0.285714285714286,7
"13798","West Virginia","Oklahoma St",4,2,0.333333333333333,6
"13799","West Virginia","Old Dominion",0,1,1,1
"13800","West Virginia","Presbyterian",0,1,1,1
"13801","West Virginia","Purdue",2,0,0,2
"13802","West Virginia","Radford",0,1,1,1
"13803","West Virginia","TCU",0,6,1,6
"13804","West Virginia","Texas",4,3,0.428571428571429,7
"13805","West Virginia","Texas Tech",0,6,1,6
"13806","West Virginia","Virginia Tech",1,2,0.666666666666667,3
"13807","West Virginia","VMI",0,2,1,2
"13808","West Virginia","William & Mary",0,1,1,1
"13809","West Virginia","Wisconsin",1,0,0,1
"13810","West Virginia","Wofford",0,1,1,1
"13811","Wichita St","Air Force",0,1,1,1
"13812","Wichita St","Alabama",0,2,1,2
"13813","Wichita St","Bradley",0,6,1,6
"13814","Wichita St","BYU",0,1,1,1
"13815","Wichita St","Charleston So",0,1,1,1
"13816","Wichita St","Creighton",1,1,0.5,2
"13817","Wichita St","Davidson",0,1,1,1
"13818","Wichita St","DePaul",0,2,1,2
"13819","Wichita St","Detroit",0,2,1,2
"13820","Wichita St","Drake",0,6,1,6
"13821","Wichita St","Evansville",2,5,0.714285714285714,7
"13822","Wichita St","G Washington",1,0,0,1
"13823","Wichita St","Hawaii",0,1,1,1
"13824","Wichita St","Howard",0,1,1,1
"13825","Wichita St","Illinois St",1,6,0.857142857142857,7
"13826","Wichita St","Indiana St",1,6,0.857142857142857,7
"13827","Wichita St","Iowa",0,1,1,1
"13828","Wichita St","Loy Marymount",0,1,1,1
"13829","Wichita St","Loyola-Chicago",0,4,1,4
"13830","Wichita St","Memphis",0,1,1,1
"13831","Wichita St","Missouri St",0,7,1,7
"13832","Wichita St","NC Central",0,2,1,2
"13833","Wichita St","N Colorado",0,1,1,1
"13834","Wichita St","New Mexico St",0,1,1,1
"13835","Wichita St","Northern Iowa",2,4,0.666666666666667,6
"13836","Wichita St","Oral Roberts",0,1,1,1
"13837","Wichita St","Seton Hall",0,1,1,1
"13838","Wichita St","S Illinois",1,6,0.857142857142857,7
"13839","Wichita St","Southern Miss",0,1,1,1
"13840","Wichita St","St Louis",0,2,1,2
"13841","Wichita St","Tennessee",1,1,0.5,2
"13842","Wichita St","Tennessee St",0,1,1,1
"13843","Wichita St","Tulsa",0,3,1,3
"13844","Wichita St","Utah",1,0,0,1
"13845","Wichita St","VA Commonwealth",0,1,1,1
"13846","Wichita St","W Carolina",0,1,1,1
"13847","Wichita St","William & Mary",0,1,1,1
"13848","Wichita St","W Kentucky",0,1,1,1
"13849","Wichita St","Emporia St",0,1,1,1
"13850","Wichita St","Newman",0,1,1,1
"13851","WI Green Bay","Ark Little Rock",0,1,1,1
"13852","WI Green Bay","Chicago St",0,3,1,3
"13853","WI Green Bay","Cleveland St",2,4,0.666666666666667,6
"13854","WI Green Bay","CS Fullerton",1,0,0,1
"13855","WI Green Bay","Detroit",1,5,0.833333333333333,6
"13856","WI Green Bay","Drake",1,1,0.5,2
"13857","WI Green Bay","East Carolina",0,1,1,1
"13858","WI Green Bay","E Michigan",1,0,0,1
"13859","WI Green Bay","Evansville",0,1,1,1
"13860","WI Green Bay","Fairfield",0,1,1,1
"13861","WI Green Bay","FL Gulf Coast",0,1,1,1
"13862","WI Green Bay","Georgia St",1,1,0.5,2
"13863","WI Green Bay","Harvard",1,0,0,1
"13864","WI Green Bay","Idaho",1,0,0,1
"13865","WI Green Bay","IL Chicago",1,6,0.857142857142857,7
"13866","WI Green Bay","Loyola-Chicago",0,2,1,2
"13867","WI Green Bay","Marquette",0,1,1,1
"13868","WI Green Bay","Miami FL",0,1,1,1
"13869","WI Green Bay","Morehead St",0,1,1,1
"13870","WI Green Bay","N Dakota St",0,1,1,1
"13871","WI Green Bay","Nevada",1,0,0,1
"13872","WI Green Bay","Oakland",1,3,0.75,4
"13873","WI Green Bay","Pepperdine",0,1,1,1
"13874","WI Green Bay","S Illinois",1,0,0,1
"13875","WI Green Bay","South Dakota",0,2,1,2
"13876","WI Green Bay","Southern Utah",0,1,1,1
"13877","WI Green Bay","Tennessee Tech",1,1,0.5,2
"13878","WI Green Bay","Tulsa",0,1,1,1
"13879","WI Green Bay","UC Irvine",1,0,0,1
"13880","WI Green Bay","Valparaiso",6,2,0.25,8
"13881","WI Green Bay","Virginia",1,1,0.5,2
"13882","WI Green Bay","WI Milwaukee",2,6,0.75,8
"13883","WI Green Bay","Wisconsin",3,0,0,3
"13884","WI Green Bay","Wright St",2,4,0.666666666666667,6
"13885","WI Green Bay","Youngstown St",0,6,1,6
"13886","WI Green Bay","MN Duluth",0,2,1,2
"13887","WI Green Bay","N Michigan",0,1,1,1
"13888","WI Green Bay","St Francis IL",0,1,1,1
"13889","WI Green Bay","IL Springfield",0,1,1,1
"13890","William & Mary","Col Charleston",2,3,0.6,5
"13891","William & Mary","Delaware",6,0,0,6
"13892","William & Mary","Drexel",2,3,0.6,5
"13893","William & Mary","Elon",1,2,0.666666666666667,3
"13894","William & Mary","Florida",1,0,0,1
"13895","William & Mary","George Mason",2,0,0,2
"13896","William & Mary","Georgia St",1,1,0.5,2
"13897","William & Mary","Hampton",1,1,0.5,2
"13898","William & Mary","High Point",2,1,0.333333333333333,3
"13899","William & Mary","Hofstra",2,5,0.714285714285714,7
"13900","William & Mary","Howard",0,3,1,3
"13901","William & Mary","James Madison",2,4,0.666666666666667,6
"13902","William & Mary","Liberty",0,2,1,2
"13903","William & Mary","Miami OH",1,0,0,1
"13904","William & Mary","North Carolina",1,0,0,1
"13905","William & Mary","Northeastern",4,3,0.428571428571429,7
"13906","William & Mary","Old Dominion",1,3,0.75,4
"13907","William & Mary","Purdue",1,0,0,1
"13908","William & Mary","Radford",0,1,1,1
"13909","William & Mary","Rice",0,1,1,1
"13910","William & Mary","Richmond",3,0,0,3
"13911","William & Mary","Rutgers",0,1,1,1
"13912","William & Mary","Towson",3,4,0.571428571428571,7
"13913","William & Mary","UNC Wilmington",0,6,1,6
"13914","William & Mary","Vanderbilt",1,0,0,1
"13915","William & Mary","VMI",0,1,1,1
"13916","William & Mary","Wake Forest",1,0,0,1
"13917","William & Mary","West Virginia",1,0,0,1
"13918","William & Mary","Wichita St",1,0,0,1
"13919","William & Mary","W Illinois",0,2,1,2
"13920","William & Mary","Wofford",0,2,1,2
"13921","William & Mary","Bluefield VA",0,1,1,1
"13922","William & Mary","Goucher",0,1,1,1
"13923","William & Mary","Washington MD",0,1,1,1
"13924","W Illinois","Akron",1,0,0,1
"13925","W Illinois","Alabama St",1,1,0.5,2
"13926","W Illinois","Alcorn St",0,1,1,1
"13927","W Illinois","Buffalo",0,1,1,1
"13928","W Illinois","Cleveland St",2,0,0,2
"13929","W Illinois","Denver",4,0,0,4
"13930","W Illinois","Edwardsville",1,1,0.5,2
"13931","W Illinois","E Illinois",0,2,1,2
"13932","W Illinois","Evansville",1,0,0,1
"13933","W Illinois","Idaho",1,1,0.5,2
"13934","W Illinois","IL Chicago",1,1,0.5,2
"13935","W Illinois","IPFW",3,3,0.5,6
"13936","W Illinois","IUPUI",1,5,0.833333333333333,6
"13937","W Illinois","Memphis",1,0,0,1
"13938","W Illinois","Missouri KC",0,2,1,2
"13939","W Illinois","N Dakota St",4,2,0.333333333333333,6
"13940","W Illinois","Nebraska",1,0,0,1
"13941","W Illinois","NE Omaha",2,4,0.666666666666667,6
"13942","W Illinois","Oakland",1,1,0.5,2
"13943","W Illinois","Oral Roberts",2,0,0,2
"13944","W Illinois","Pacific",2,0,0,2
"13945","W Illinois","Santa Barbara",1,0,0,1
"13946","W Illinois","Savannah St",1,1,0.5,2
"13947","W Illinois","S Dakota St",8,0,0,8
"13948","W Illinois","SE Louisiana",1,1,0.5,2
"13949","W Illinois","South Dakota",3,3,0.5,6
"13950","W Illinois","Troy",0,1,1,1
"13951","W Illinois","Utah St",1,0,0,1
"13952","W Illinois","UTEP",1,0,0,1
"13953","W Illinois","William & Mary",2,0,0,2
"13954","W Illinois","Yale",0,1,1,1
"13955","W Illinois","Anderson IN",0,1,1,1
"13956","W Illinois","Eureka",0,1,1,1
"13957","W Illinois","Grace Bib",0,1,1,1
"13958","W Illinois","Greenville",0,2,1,2
"13959","WI Milwaukee","Alabama St",0,1,1,1
"13960","WI Milwaukee","Arkansas",1,0,0,1
"13961","WI Milwaukee","Ark Little Rock",1,0,0,1
"13962","WI Milwaukee","Auburn",1,0,0,1
"13963","WI Milwaukee","Bradley",0,1,1,1
"13964","WI Milwaukee","Buffalo",1,0,0,1
"13965","WI Milwaukee","Cleveland St",4,2,0.333333333333333,6
"13966","WI Milwaukee","Davidson",0,2,1,2
"13967","WI Milwaukee","DePaul",3,0,0,3
"13968","WI Milwaukee","Detroit",4,3,0.428571428571429,7
"13969","WI Milwaukee","Edwardsville",1,0,0,1
"13970","WI Milwaukee","Fairfield",1,0,0,1
"13971","WI Milwaukee","IL Chicago",2,4,0.666666666666667,6
"13972","WI Milwaukee","IUPUI",1,1,0.5,2
"13973","WI Milwaukee","Jacksonville",1,0,0,1
"13974","WI Milwaukee","James Madison",0,1,1,1
"13975","WI Milwaukee","Loyola-Chicago",2,1,0.333333333333333,3
"13976","WI Milwaukee","Missouri KC",0,2,1,2
"13977","WI Milwaukee","Montana",0,1,1,1
"13978","WI Milwaukee","N Illinois",0,2,1,2
"13979","WI Milwaukee","Northeastern",1,0,0,1
"13980","WI Milwaukee","Northern Iowa",1,1,0.5,2
"13981","WI Milwaukee","Oakland",1,3,0.75,4
"13982","WI Milwaukee","Oklahoma St",1,0,0,1
"13983","WI Milwaukee","Oral Roberts",1,0,0,1
"13984","WI Milwaukee","Rider",1,0,0,1
"13985","WI Milwaukee","San Jose St",0,1,1,1
"13986","WI Milwaukee","South Carolina",1,0,0,1
"13987","WI Milwaukee","South Dakota",1,0,0,1
"13988","WI Milwaukee","Tennessee Tech",1,1,0.5,2
"13989","WI Milwaukee","ULL",0,1,1,1
"13990","WI Milwaukee","Valparaiso",6,1,0.142857142857143,7
"13991","WI Milwaukee","WI Green Bay",6,2,0.25,8
"13992","WI Milwaukee","Wisconsin",3,0,0,3
"13993","WI Milwaukee","Wright St",3,4,0.571428571428571,7
"13994","WI Milwaukee","Youngstown St",3,3,0.5,6
"13995","WI Milwaukee","Judson IL",0,1,1,1
"13996","WI Milwaukee","Concordia SP",0,1,1,1
"13997","WI Milwaukee","MN Crookston",0,1,1,1
"13998","Winthrop","Appalachian St",0,1,1,1
"13999","Winthrop","Auburn",1,1,0.5,2
"14000","Winthrop","Campbell",2,2,0.5,4
"14001","Winthrop","Charleston So",2,3,0.6,5
"14002","Winthrop","Clemson",0,1,1,1
"14003","Winthrop","Coastal Car",3,4,0.571428571428571,7
"14004","Winthrop","Dayton",1,0,0,1
"14005","Winthrop","ETSU",1,1,0.5,2
"14006","Winthrop","Gardner Webb",4,2,0.333333333333333,6
"14007","Winthrop","Hampton",1,1,0.5,2
"14008","Winthrop","High Point",4,1,0.2,5
"14009","Winthrop","Indiana St",1,0,0,1
"14010","Winthrop","Jacksonville St",1,0,0,1
"14011","Winthrop","James Madison",1,1,0.5,2
"14012","Winthrop","Liberty",0,5,1,5
"14013","Winthrop","Longwood",1,4,0.8,5
"14014","Winthrop","Maryland",1,0,0,1
"14015","Winthrop","NC Central",2,0,0,2
"14016","Winthrop","Ohio",0,1,1,1
"14017","Winthrop","Ohio St",1,0,0,1
"14018","Winthrop","Presbyterian",1,5,0.833333333333333,6
"14019","Winthrop","Radford",4,1,0.2,5
"14020","Winthrop","Savannah St",1,1,0.5,2
"14021","Winthrop","SC Upstate",0,1,1,1
"14022","Winthrop","SE Louisiana",1,1,0.5,2
"14023","Winthrop","UNC Asheville",2,5,0.714285714285714,7
"14024","Winthrop","VA Commonwealth",2,0,0,2
"14025","Winthrop","Virginia Tech",1,0,0,1
"14026","Winthrop","VMI",1,1,0.5,2
"14027","Winthrop","Wofford",2,0,0,2
"14028","Winthrop","Barber-Scotia",0,1,1,1
"14029","Winthrop","Mars Hill",0,1,1,1
"14030","Winthrop","Reinhardt",0,1,1,1
"14031","Winthrop","Roanoke",0,1,1,1
"14032","Winthrop","VA Intermont",0,1,1,1
"14033","Winthrop","Pfeiffer",0,1,1,1
"14034","Wisconsin","Arkansas",0,1,1,1
"14035","Wisconsin","Boise St",0,1,1,1
"14036","Wisconsin","Bowling Green",0,1,1,1
"14037","Wisconsin","Buffalo",0,1,1,1
"14038","Wisconsin","California",0,2,1,2
"14039","Wisconsin","Chattanooga",0,1,1,1
"14040","Wisconsin","Cornell",0,1,1,1
"14041","Wisconsin","Creighton",1,0,0,1
"14042","Wisconsin","Duke",1,0,0,1
"14043","Wisconsin","E Kentucky",0,1,1,1
"14044","Wisconsin","Florida",1,1,0.5,2
"14045","Wisconsin","Georgetown",0,1,1,1
"14046","Wisconsin","Illinois",0,5,1,5
"14047","Wisconsin","Indiana",1,3,0.75,4
"14048","Wisconsin","Iowa",1,5,0.833333333333333,6
"14049","Wisconsin","Marquette",1,2,0.666666666666667,3
"14050","Wisconsin","Maryland",1,0,0,1
"14051","Wisconsin","Michigan",1,4,0.8,5
"14052","Wisconsin","Michigan St",3,3,0.5,6
"14053","Wisconsin","Minnesota",2,5,0.714285714285714,7
"14054","Wisconsin","Nebraska",1,4,0.8,5
"14055","Wisconsin","NE Omaha",0,1,1,1
"14056","Wisconsin","Nicholls St",0,1,1,1
"14057","Wisconsin","N Kentucky",0,1,1,1
"14058","Wisconsin","North Dakota",0,1,1,1
"14059","Wisconsin","Northwestern",1,4,0.8,5
"14060","Wisconsin","Ohio St",2,2,0.5,4
"14061","Wisconsin","Oklahoma",0,1,1,1
"14062","Wisconsin","Oral Roberts",0,1,1,1
"14063","Wisconsin","Penn St",0,5,1,5
"14064","Wisconsin","Prairie View",0,1,1,1
"14065","Wisconsin","Presbyterian",0,1,1,1
"14066","Wisconsin","Purdue",1,4,0.8,5
"14067","Wisconsin","Rutgers",1,0,0,1
"14068","Wisconsin","Samford",0,1,1,1
"14069","Wisconsin","SE Louisiana",0,1,1,1
"14070","Wisconsin","St John's",0,1,1,1
"14071","Wisconsin","St Louis",0,1,1,1
"14072","Wisconsin","UAB",0,1,1,1
"14073","Wisconsin","Virginia",1,1,0.5,2
"14074","Wisconsin","West Virginia",0,1,1,1
"14075","Wisconsin","WI Green Bay",0,3,1,3
"14076","Wisconsin","WI Milwaukee",0,3,1,3
"14077","W Kentucky","Arkansas St",3,1,0.25,4
"14078","W Kentucky","Ark Little Rock",3,1,0.25,4
"14079","W Kentucky","Austin Peay",0,2,1,2
"14080","W Kentucky","Belmont",1,0,0,1
"14081","W Kentucky","Bowling Green",1,1,0.5,2
"14082","W Kentucky","Charlotte",0,2,1,2
"14083","W Kentucky","Chicago St",0,1,1,1
"14084","W Kentucky","DePaul",0,1,1,1
"14085","W Kentucky","E Illinois",0,1,1,1
"14086","W Kentucky","ETSU",0,1,1,1
"14087","W Kentucky","FL Atlantic",2,2,0.5,4
"14088","W Kentucky","Florida Intl",1,3,0.75,4
"14089","W Kentucky","Georgia St",2,0,0,2
"14090","W Kentucky","Iowa",1,0,0,1
"14091","W Kentucky","IUPUI",0,1,1,1
"14092","W Kentucky","Louisiana Tech",1,0,0,1
"14093","W Kentucky","Louisville",3,0,0,3
"14094","W Kentucky","Marshall",2,2,0.5,4
"14095","W Kentucky","Middle Tenn St",2,0,0,2
"14096","W Kentucky","Minnesota",1,0,0,1
"14097","W Kentucky","Mississippi",1,1,0.5,2
"14098","W Kentucky","Murray St",2,1,0.333333333333333,3
"14099","W Kentucky","North Texas",0,3,1,3
"14100","W Kentucky","Old Dominion",1,1,0.5,2
"14101","W Kentucky","Rice",1,0,0,1
"14102","W Kentucky","Samford",0,1,1,1
"14103","W Kentucky","S Illinois",0,2,1,2
"14104","W Kentucky","South Alabama",2,2,0.5,4
"14105","W Kentucky","Southern Miss",1,2,0.666666666666667,3
"14106","W Kentucky","St Joseph's PA",0,1,1,1
"14107","W Kentucky","Stony Brook",1,0,0,1
"14108","W Kentucky","Texas St",0,2,1,2
"14109","W Kentucky","Troy",0,4,1,4
"14110","W Kentucky","UAB",2,0,0,2
"14111","W Kentucky","ULL",1,4,0.8,5
"14112","W Kentucky","ULM",0,4,1,4
"14113","W Kentucky","UNC Wilmington",0,1,1,1
"14114","W Kentucky","UT Arlington",1,1,0.5,2
"14115","W Kentucky","UTEP",0,1,1,1
"14116","W Kentucky","UT San Antonio",0,1,1,1
"14117","W Kentucky","VA Commonwealth",1,0,0,1
"14118","W Kentucky","W Carolina",0,1,1,1
"14119","W Kentucky","Wichita St",1,0,0,1
"14120","W Kentucky","Alice Lloyd",0,1,1,1
"14121","W Kentucky","Brescia",0,2,1,2
"14122","W Kentucky","MTSU",1,0,0,1
"14123","W Michigan","Akron",4,2,0.333333333333333,6
"14124","W Michigan","Alabama A&M",0,2,1,2
"14125","W Michigan","Ball St",2,4,0.666666666666667,6
"14126","W Michigan","Bowling Green",3,0,0,3
"14127","W Michigan","Buffalo",2,2,0.5,4
"14128","W Michigan","C Michigan",1,5,0.833333333333333,6
"14129","W Michigan","Cornell",1,1,0.5,2
"14130","W Michigan","Drake",1,1,0.5,2
"14131","W Michigan","Duquesne",1,0,0,1
"14132","W Michigan","E Michigan",3,3,0.5,6
"14133","W Michigan","Hawaii",1,0,0,1
"14134","W Michigan","High Point",0,2,1,2
"14135","W Michigan","Illinois St",1,0,0,1
"14136","W Michigan","Kent",0,3,1,3
"14137","W Michigan","Long Beach St",1,0,0,1
"14138","W Michigan","Loyola-Chicago",0,1,1,1
"14139","W Michigan","MD E Shore",0,1,1,1
"14140","W Michigan","Miami OH",0,4,1,4
"14141","W Michigan","Michigan",1,0,0,1
"14142","W Michigan","Missouri",1,0,0,1
"14143","W Michigan","Mt St Mary's",0,1,1,1
"14144","W Michigan","NC State",1,0,0,1
"14145","W Michigan","N Dakota St",1,0,0,1
"14146","W Michigan","New Hampshire",0,1,1,1
"14147","W Michigan","New Mexico St",0,1,1,1
"14148","W Michigan","N Illinois",1,5,0.833333333333333,6
"14149","W Michigan","Northeastern",1,0,0,1
"14150","W Michigan","Northwestern",2,0,0,2
"14151","W Michigan","Oakland",0,3,1,3
"14152","W Michigan","Ohio",1,4,0.8,5
"14153","W Michigan","Pacific",0,2,1,2
"14154","W Michigan","Prairie View",0,1,1,1
"14155","W Michigan","San Diego",1,1,0.5,2
"14156","W Michigan","San Jose St",0,1,1,1
"14157","W Michigan","South Florida",0,1,1,1
"14158","W Michigan","Tennessee St",0,1,1,1
"14159","W Michigan","Toledo",2,5,0.714285714285714,7
"14160","W Michigan","Rochester MI",0,1,1,1
"14161","W Michigan","Siena Hts",0,1,1,1
"14162","W Michigan","Aquinas",0,1,1,1
"14163","Wofford","Appalachian St",1,1,0.5,2
"14164","Wofford","Ball St",1,0,0,1
"14165","Wofford","Charleston So",0,1,1,1
"14166","Wofford","Chattanooga",3,2,0.4,5
"14167","Wofford","Citadel",2,5,0.714285714285714,7
"14168","Wofford","Col Charleston",2,0,0,2
"14169","Wofford","Colorado",1,0,0,1
"14170","Wofford","Davidson",4,0,0,4
"14171","Wofford","Duke",1,0,0,1
"14172","Wofford","Elon",1,2,0.666666666666667,3
"14173","Wofford","ETSU",0,2,1,2
"14174","Wofford","Fairfield",0,1,1,1
"14175","Wofford","Furman",1,6,0.857142857142857,7
"14176","Wofford","Gardner Webb",0,2,1,2
"14177","Wofford","Ga Southern",0,5,1,5
"14178","Wofford","Georgia",1,0,0,1
"14179","Wofford","Hampton",0,1,1,1
"14180","Wofford","High Point",1,1,0.5,2
"14181","Wofford","Iona",1,1,0.5,2
"14182","Wofford","Jacksonville",0,1,1,1
"14183","Wofford","Mercer",0,2,1,2
"14184","Wofford","Minnesota",1,0,0,1
"14185","Wofford","NC State",0,1,1,1
"14186","Wofford","Ohio",1,0,0,1
"14187","Wofford","Presbyterian",0,1,1,1
"14188","Wofford","Richmond",1,0,0,1
"14189","Wofford","Samford",1,4,0.8,5
"14190","Wofford","Sam Houston St",0,1,1,1
"14191","Wofford","South Dakota",0,1,1,1
"14192","Wofford","Stanford",1,0,0,1
"14193","Wofford","St Louis",1,0,0,1
"14194","Wofford","Tulane",1,0,0,1
"14195","Wofford","UNC Greensboro",2,4,0.666666666666667,6
"14196","Wofford","UNC Wilmington",1,0,0,1
"14197","Wofford","VA Commonwealth",1,0,0,1
"14198","Wofford","Virginia",1,0,0,1
"14199","Wofford","VMI",0,2,1,2
"14200","Wofford","W Carolina",1,5,0.833333333333333,6
"14201","Wofford","West Virginia",1,0,0,1
"14202","Wofford","William & Mary",2,0,0,2
"14203","Wofford","Winthrop",0,2,1,2
"14204","Wofford","Xavier",0,1,1,1
"14205","Wofford","Emory & Henry",0,1,1,1
"14206","Wofford","Florida National",0,1,1,1
"14207","Wofford","Hiwassee",0,1,1,1
"14208","Wofford","J&W NC",0,1,1,1
"14209","Wofford","Ohio Valley",0,1,1,1
"14210","Wright St","Alcorn St",0,1,1,1
"14211","Wright St","Belmont",0,2,1,2
"14212","Wright St","Bowling Green",2,1,0.333333333333333,3
"14213","Wright St","Charleston So",0,1,1,1
"14214","Wright St","Cincinnati",1,0,0,1
"14215","Wright St","Cleveland St",3,4,0.571428571428571,7
"14216","Wright St","C Michigan",1,0,0,1
"14217","Wright St","CS Fullerton",1,0,0,1
"14218","Wright St","DePaul",1,0,0,1
"14219","Wright St","Detroit",2,4,0.666666666666667,6
"14220","Wright St","E Illinois",0,2,1,2
"14221","Wright St","Evansville",2,0,0,2
"14222","Wright St","Florida Intl",1,0,0,1
"14223","Wright St","George Mason",1,0,0,1
"14224","Wright St","Georgetown",1,0,0,1
"14225","Wright St","Hofstra",0,1,1,1
"14226","Wright St","Houston Bap",0,1,1,1
"14227","Wright St","Idaho",0,1,1,1
"14228","Wright St","Idaho St",0,1,1,1
"14229","Wright St","IL Chicago",5,2,0.285714285714286,7
"14230","Wright St","Loyola-Chicago",0,2,1,2
"14231","Wright St","Miami OH",1,2,0.666666666666667,3
"14232","Wright St","Missouri KC",0,1,1,1
"14233","Wright St","Morehead St",1,1,0.5,2
"14234","Wright St","NC A&T",1,1,0.5,2
"14235","Wright St","Oakland",2,3,0.6,5
"14236","Wright St","Ohio St",1,0,0,1
"14237","Wright St","SC Upstate",0,1,1,1
"14238","Wright St","South Alabama",1,0,0,1
"14239","Wright St","Utah",1,0,0,1
"14240","Wright St","Valparaiso",4,2,0.333333333333333,6
"14241","Wright St","VMI",1,1,0.5,2
"14242","Wright St","W Carolina",0,2,1,2
"14243","Wright St","WI Green Bay",4,2,0.333333333333333,6
"14244","Wright St","WI Milwaukee",4,3,0.428571428571429,7
"14245","Wright St","Youngstown St",3,3,0.5,6
"14246","Wright St","Manchester",0,1,1,1
"14247","Wright St","Mt St Joseph",0,1,1,1
"14248","Wright St","Urbana",0,1,1,1
"14249","Wright St","OH Dominican",0,1,1,1
"14250","Wyoming","Air Force",4,1,0.2,5
"14251","Wyoming","Arkansas St",0,1,1,1
"14252","Wyoming","Boise St",3,3,0.5,6
"14253","Wyoming","California",1,0,0,1
"14254","Wyoming","Colorado",1,2,0.666666666666667,3
"14255","Wyoming","Colorado St",3,3,0.5,6
"14256","Wyoming","CS Bakersfield",0,2,1,2
"14257","Wyoming","Denver",1,2,0.666666666666667,3
"14258","Wyoming","Florida A&M",0,1,1,1
"14259","Wyoming","Fresno St",3,3,0.5,6
"14260","Wyoming","Illinois St",0,1,1,1
"14261","Wyoming","Jackson St",0,1,1,1
"14262","Wyoming","Montana St",0,3,1,3
"14263","Wyoming","NC Central",0,1,1,1
"14264","Wyoming","N Colorado",0,3,1,3
"14265","Wyoming","Nevada",1,5,0.833333333333333,6
"14266","Wyoming","New Mexico",5,1,0.166666666666667,6
"14267","Wyoming","New Mexico St",0,1,1,1
"14268","Wyoming","Ohio St",1,0,0,1
"14269","Wyoming","San Diego St",3,3,0.5,6
"14270","Wyoming","San Jose St",0,4,1,4
"14271","Wyoming","Santa Barbara",0,2,1,2
"14272","Wyoming","SMU",2,1,0.333333333333333,3
"14273","Wyoming","South Dakota",0,3,1,3
"14274","Wyoming","Southern Univ",0,2,1,2
"14275","Wyoming","Stetson",0,1,1,1
"14276","Wyoming","TN Martin",0,1,1,1
"14277","Wyoming","UNLV",5,1,0.166666666666667,6
"14278","Wyoming","Utah St",2,3,0.6,5
"14279","Wyoming","Black Hills St",0,1,1,1
"14280","Wyoming","Western St CO",0,2,1,2
"14281","Wyoming","Regis CO",0,1,1,1
"14282","Xavier","Alabama",0,2,1,2
"14283","Xavier","Auburn",1,0,0,1
"14284","Xavier","Bowling Green",0,1,1,1
"14285","Xavier","Butler",2,5,0.714285714285714,7
"14286","Xavier","Charlotte",1,0,0,1
"14287","Xavier","Cincinnati",1,2,0.666666666666667,3
"14288","Xavier","Creighton",3,2,0.4,5
"14289","Xavier","Dayton",1,1,0.5,2
"14290","Xavier","DePaul",1,3,0.75,4
"14291","Xavier","Drake",0,1,1,1
"14292","Xavier","Drexel",0,1,1,1
"14293","Xavier","Duquesne",0,1,1,1
"14294","Xavier","Evansville",0,1,1,1
"14295","Xavier","F Dickinson",0,1,1,1
"14296","Xavier","FL Gulf Coast",0,1,1,1
"14297","Xavier","Fordham",0,1,1,1
"14298","Xavier","Gardner Webb",0,1,1,1
"14299","Xavier","Georgetown",1,4,0.8,5
"14300","Xavier","G Washington",0,1,1,1
"14301","Xavier","Iowa",1,0,0,1
"14302","Xavier","IUPUI",0,1,1,1
"14303","Xavier","Kent",0,1,1,1
"14304","Xavier","La Salle",0,1,1,1
"14305","Xavier","Long Beach St",1,1,0.5,2
"14306","Xavier","Marquette",1,4,0.8,5
"14307","Xavier","Massachusetts",1,0,0,1
"14308","Xavier","Memphis",0,1,1,1
"14309","Xavier","Miami OH",0,1,1,1
"14310","Xavier","Missouri",0,1,1,1
"14311","Xavier","Morehead St",0,1,1,1
"14312","Xavier","Murray St",0,1,1,1
"14313","Xavier","Northern Arizona",0,1,1,1
"14314","Xavier","Pacific",1,0,0,1
"14315","Xavier","Providence",2,2,0.5,4
"14316","Xavier","Purdue",0,1,1,1
"14317","Xavier","Rhode Island",0,1,1,1
"14318","Xavier","Richmond",1,0,0,1
"14319","Xavier","Robert Morris",0,1,1,1
"14320","Xavier","San Diego",0,1,1,1
"14321","Xavier","Seton Hall",3,1,0.25,4
"14322","Xavier","SF Austin",0,1,1,1
"14323","Xavier","St Bonaventure",0,1,1,1
"14324","Xavier","St John's",2,2,0.5,4
"14325","Xavier","St Joseph's PA",1,0,0,1
"14326","Xavier","St Louis",0,1,1,1
"14327","Xavier","Temple",0,1,1,1
"14328","Xavier","Tennessee",2,1,0.333333333333333,3
"14329","Xavier","USC",1,0,0,1
"14330","Xavier","UTEP",1,0,0,1
"14331","Xavier","VA Commonwealth",1,0,0,1
"14332","Xavier","Vanderbilt",1,0,0,1
"14333","Xavier","Villanova",5,0,0,5
"14334","Xavier","Wake Forest",1,1,0.5,2
"14335","Xavier","Wofford",1,0,0,1
"14336","Xavier","Abilene Chr",0,1,1,1
"14337","Yale","Albany NY",2,0,0,2
"14338","Yale","Army",0,1,1,1
"14339","Yale","Brown",2,4,0.666666666666667,6
"14340","Yale","Bryant",1,2,0.666666666666667,3
"14341","Yale","Buffalo",0,1,1,1
"14342","Yale","Central Conn",0,1,1,1
"14343","Yale","Columbia",3,3,0.5,6
"14344","Yale","Connecticut",1,1,0.5,2
"14345","Yale","Cornell",1,5,0.833333333333333,6
"14346","Yale","Dartmouth",3,3,0.5,6
"14347","Yale","Evansville",1,0,0,1
"14348","Yale","Florida",2,0,0,2
"14349","Yale","Hartford",1,2,0.666666666666667,3
"14350","Yale","Harvard",5,2,0.285714285714286,7
"14351","Yale","Holy Cross",0,1,1,1
"14352","Yale","IL Chicago",0,1,1,1
"14353","Yale","Iowa St",1,0,0,1
"14354","Yale","Kent",0,1,1,1
"14355","Yale","Lafayette",0,2,1,2
"14356","Yale","Mercer",1,0,0,1
"14357","Yale","Nevada",1,0,0,1
"14358","Yale","New Hampshire",1,1,0.5,2
"14359","Yale","NJIT",1,0,0,1
"14360","Yale","Penn",0,6,1,6
"14361","Yale","Princeton",1,5,0.833333333333333,6
"14362","Yale","Providence",2,0,0,2
"14363","Yale","Quinnipiac",1,0,0,1
"14364","Yale","Rutgers",1,0,0,1
"14365","Yale","Sacred Heart",1,2,0.666666666666667,3
"14366","Yale","S Illinois",0,1,1,1
"14367","Yale","St Joseph's PA",1,0,0,1
"14368","Yale","St Louis",1,0,0,1
"14369","Yale","St Mary's CA",1,0,0,1
"14370","Yale","Vanderbilt",1,0,0,1
"14371","Yale","Vermont",2,1,0.333333333333333,3
"14372","Yale","W Illinois",1,0,0,1
"14373","Yale","Baruch",0,1,1,1
"14374","Yale","Daniel Webster",0,1,1,1
"14375","Yale","Newbury",0,1,1,1
"14376","Youngstown St","Austin Peay",1,0,0,1
"14377","Youngstown St","Bethune-Cookman",0,2,1,2
"14378","Youngstown St","Bowling Green",0,1,1,1
"14379","Youngstown St","Cleveland St",4,2,0.333333333333333,6
"14380","Youngstown St","C Michigan",1,1,0.5,2
"14381","Youngstown St","Detroit",6,1,0.142857142857143,7
"14382","Youngstown St","Duquesne",1,0,0,1
"14383","Youngstown St","E Kentucky",0,1,1,1
"14384","Youngstown St","E Michigan",1,0,0,1
"14385","Youngstown St","Florida Intl",0,1,1,1
"14386","Youngstown St","Georgia",0,1,1,1
"14387","Youngstown St","G Washington",0,1,1,1
"14388","Youngstown St","IL Chicago",3,3,0.5,6
"14389","Youngstown St","Illinois St",1,0,0,1
"14390","Youngstown St","James Madison",1,0,0,1
"14391","Youngstown St","Kennesaw",1,1,0.5,2
"14392","Youngstown St","Kent",3,0,0,3
"14393","Youngstown St","Longwood",0,1,1,1
"14394","Youngstown St","Loyola-Chicago",0,3,1,3
"14395","Youngstown St","Massachusetts",1,0,0,1
"14396","Youngstown St","Missouri KC",1,1,0.5,2
"14397","Youngstown St","N Dakota St",1,0,0,1
"14398","Youngstown St","N Kentucky",0,1,1,1
"14399","Youngstown St","Oakland",5,0,0,5
"14400","Youngstown St","Pittsburgh",1,0,0,1
"14401","Youngstown St","Robert Morris",0,2,1,2
"14402","Youngstown St","South Dakota",0,2,1,2
"14403","Youngstown St","South Florida",1,0,0,1
"14404","Youngstown St","St Francis PA",0,1,1,1
"14405","Youngstown St","St John's",1,0,0,1
"14406","Youngstown St","Texas A&M",1,0,0,1
"14407","Youngstown St","UNC Greensboro",0,1,1,1
"14408","Youngstown St","Valparaiso",5,1,0.166666666666667,6
"14409","Youngstown St","WI Green Bay",6,0,0,6
"14410","Youngstown St","WI Milwaukee",3,3,0.5,6
"14411","Youngstown St","Wright St",3,3,0.5,6
"14412","Youngstown St","Oberlin",0,1,1,1
"14413","Youngstown St","Thiel",0,2,1,2
"14414","Youngstown St","Warren Wilson",0,1,1,1
"14415","Youngstown St","Westminster PA",0,1,1,1
"14416","Youngstown St","Wilberforce",0,1,1,1
"14417","Abilene Chr","Ark Pine Bluff",0,1,1,1
"14418","Abilene Chr","Boise St",1,0,0,1
"14419","Abilene Chr","Cent Arkansas",0,2,1,2
"14420","Abilene Chr","CS Sacramento",0,1,1,1
"14421","Abilene Chr","Duquesne",2,0,0,2
"14422","Abilene Chr","Houston",1,0,0,1
"14423","Abilene Chr","Houston Bap",1,2,0.666666666666667,3
"14424","Abilene Chr","Iowa",1,0,0,1
"14425","Abilene Chr","Lamar",3,0,0,3
"14426","Abilene Chr","Loyola-Chicago",1,0,0,1
"14427","Abilene Chr","Maryland",1,0,0,1
"14428","Abilene Chr","McNeese St",2,0,0,2
"14429","Abilene Chr","New Orleans",2,0,0,2
"14430","Abilene Chr","Nicholls St",1,1,0.5,2
"14431","Abilene Chr","Northwestern LA",1,1,0.5,2
"14432","Abilene Chr","Oral Roberts",1,0,0,1
"14433","Abilene Chr","Sam Houston St",3,0,0,3
"14434","Abilene Chr","S Carolina St",0,1,1,1
"14435","Abilene Chr","SE Louisiana",3,0,0,3
"14436","Abilene Chr","SF Austin",2,0,0,2
"14437","Abilene Chr","St Bonaventure",1,0,0,1
"14438","Abilene Chr","TAM C. Christi",3,0,0,3
"14439","Abilene Chr","TCU",1,0,0,1
"14440","Abilene Chr","Towson",1,0,0,1
"14441","Abilene Chr","Tulsa",1,0,0,1
"14442","Abilene Chr","UC Riverside",1,0,0,1
"14443","Abilene Chr","Xavier",1,0,0,1
"14444","Abilene Chr","Arlington Bap",0,1,1,1
"14445","Abilene Chr","Bacone",0,1,1,1
"14446","Abilene Chr","Dallas Chr",0,1,1,1
"14447","Abilene Chr","Grand Canyon",1,0,0,1
"14448","Abilene Chr","Hillsdale Bap",0,2,1,2
"14449","Abilene Chr","Incarnate Word",4,0,0,4
"14450","Abilene Chr","Jarvis Chr",0,1,1,1
"14451","Abilene Chr","N New Mexico",0,2,1,2
"14452","Abilene Chr","Open Bible",0,2,1,2
"14453","Abilene Chr","SW Adventist",0,1,1,1
"14454","Abilene Chr","West Alabama",1,0,0,1
"14455","Abilene Chr","W New Mexico",0,1,1,1
"14456","AK Anchorage","Denver",1,0,0,1
"14457","AK Anchorage","Indiana St",1,0,0,1
"14458","AK Anchorage","Missouri St",1,0,0,1
"14459","AK Anchorage","Pacific",1,0,0,1
"14460","AK Anchorage","Rice",0,1,1,1
"14461","AK Anchorage","TCU",1,0,0,1
"14462","Albertus Magnus","Central Conn",1,0,0,1
"14463","Albion","E Michigan",1,0,0,1
"14464","Albion","Oakland",1,0,0,1
"14465","AL Huntsville","Alabama A&M",1,0,0,1
"14466","Alice Lloyd","Marshall",1,0,0,1
"14467","Alice Lloyd","W Kentucky",1,0,0,1
"14468","Allen","Furman",1,0,0,1
"14469","Allen","Gardner Webb",1,0,0,1
"14470","Allen","Savannah St",1,0,0,1
"14471","Anderson IN","Evansville",1,0,0,1
"14472","Anderson IN","W Illinois",1,0,0,1
"14473","Arizona Chr","Southern Utah",1,0,0,1
"14474","Arkansas-FS","Ark Little Rock",1,0,0,1
"14475","Arkansas-FS","Colorado St",1,0,0,1
"14476","Arlington Bap","Houston Bap",2,0,0,2
"14477","Arlington Bap","Abilene Chr",1,0,0,1
"14478","Asbury","Morehead St",1,0,0,1
"14479","Auburn M'gomery","Alabama St",2,0,0,2
"14480","Auburn M'gomery","Samford",1,0,0,1
"14481","Ave Maria","FL Atlantic",2,0,0,2
"14482","Ave Maria","FL Gulf Coast",2,0,0,2
"14483","Bacone","Abilene Chr",1,0,0,1
"14484","Bap Bible PA","Delaware St",2,0,0,2
"14485","Barber-Scotia","Campbell",1,0,0,1
"14486","Barber-Scotia","NC Central",2,0,0,2
"14487","Barber-Scotia","SC Upstate",1,0,0,1
"14488","Barber-Scotia","Winthrop",1,0,0,1
"14489","Baruch","Yale",1,0,0,1
"14490","Belhaven MS","Arkansas St",1,0,0,1
"14491","Belhaven MS","Troy",1,0,0,1
"14492","Bethel TN","Murray St",2,0,0,2
"14493","Bethel TN","TN Martin",1,0,0,1
"14494","Bethesda","Cal Poly SLO",1,0,0,1
"14495","Bethesda","CS Northridge",1,0,0,1
"14496","Bethesda","San Jose St",1,0,0,1
"14497","Bethesda","Santa Clara",1,0,0,1
"14498","B Jones","SC Upstate",1,0,0,1
"14499","Black Hills St","N Colorado",1,0,0,1
"14500","Black Hills St","Wyoming",1,0,0,1
"14501","Bluefield VA","Appalachian St",1,0,0,1
"14502","Bluefield VA","Liberty",1,0,0,1
"14503","Bluefield VA","UNC Asheville",1,0,0,1
"14504","Bluefield VA","William & Mary",1,0,0,1
"14505","Bluefield WV","Duquesne",1,0,0,1
"14506","Bluefield WV","Longwood",1,0,0,1
"14507","Bluefield WV","VMI",1,0,0,1
"14508","Blue Mtn","Southern Univ",1,0,0,1
"14509","Brescia","Belmont",1,0,0,1
"14510","Brescia","E Kentucky",1,0,0,1
"14511","Brescia","Murray St",2,0,0,2
"14512","Brescia","W Kentucky",2,0,0,2
"14513","Brevard","Citadel",1,0,0,1
"14514","Brevard","Furman",1,0,0,1
"14515","Brevard","Gardner Webb",1,0,0,1
"14516","Brevard","Radford",1,0,0,1
"14517","Brewton-Parker","Ga Southern",1,0,0,1
"14518","Brewton-Parker","Troy",1,0,0,1
"14519","Bridgewater VA","VMI",1,0,0,1
"14520","Cairn","Delaware St",1,0,0,1
"14521","Caldwell","Binghamton",0,1,1,1
"14522","Caldwell","F Dickinson",1,0,0,1
"14523","Cameron","Missouri St",1,0,0,1
"14524","Cameron","Oral Roberts",1,0,0,1
"14525","Cameron","UT San Antonio",2,0,0,2
"14526","Campbellsville","Samford",1,0,0,1
"14527","Campbellsville","UNC Wilmington",1,0,0,1
"14528","Carroll MT","Boise St",1,0,0,1
"14529","Carroll MT","Idaho St",1,0,0,1
"14530","Carroll MT","Montana",1,0,0,1
"14531","Carroll MT","South Alabama",1,0,0,1
"14532","Carroll MT","Utah",1,0,0,1
"14533","Catholic","Davidson",1,0,0,1
"14534","Catholic","Loyola MD",1,0,0,1
"14535","Cedarville","Texas St",1,0,0,1
"14536","Cedarville","Tulane",1,0,0,1
"14537","Centenary","Louisiana Tech",1,0,0,1
"14538","Centenary","ULL",2,0,0,2
"14539","Cent Methodist","ULL",1,0,0,1
"14540","Central Bap","Grambling",1,0,0,1
"14541","Central Bap","New Orleans",1,0,0,1
"14542","Central Bap","SE Missouri St",1,0,0,1
"14543","Central Bap","ULM",1,0,0,1
"14544","Central Penn","C Michigan",1,0,0,1
"14545","Central Penn","Columbia",2,0,0,2
"14546","Central Penn","Elon",2,0,0,2
"14547","Central Penn","Liberty",1,0,0,1
"14548","Central Penn","Radford",2,0,0,2
"14549","Central Penn","Towson",1,0,0,1
"14550","Chaminade","Baylor",1,0,0,1
"14551","Chaminade","BYU",1,0,0,1
"14552","Chaminade","Gonzaga",1,0,0,1
"14553","Chaminade","Hawaii",2,0,0,2
"14554","Chaminade","Minnesota",1,0,0,1
"14555","Chaminade","Missouri",1,0,0,1
"14556","Chaminade","Pittsburgh",1,0,0,1
"14557","Champion Bap","Lamar",1,0,0,1
"14558","Champion Bap","MS Valley St",1,0,0,1
"14559","Champion Bap","New Orleans",1,0,0,1
"14560","Champion Bap","SE Louisiana",1,0,0,1
"14561","Champion Bap","Southern Univ",2,0,0,2
"14562","Champion Bap","TN Martin",1,0,0,1
"14563","Champion Bap","ULM",1,0,0,1
"14564","Chestnut Hill","Wagner",1,0,0,1
"14565","Chowan","Campbell",0,1,1,1
"14566","Chowan","East Carolina",1,0,0,1
"14567","Chowan","UNC Greensboro",2,0,0,2
"14568","Cincinnati Chr","IUPUI",1,0,0,1
"14569","Cincinnati Chr","Liberty",1,0,0,1
"14570","Cincinnati Chr","Morehead St",1,0,0,1
"14571","Cincinnati Chr","Valparaiso",1,0,0,1
"14572","City Col NY","NJIT",1,0,0,1
"14573","Claflin","UNC Greensboro",1,0,0,1
"14574","Clearwater Chr","Gardner Webb",1,0,0,1
"14575","Coast Guard","Army",2,0,0,2
"14576","Coe","Northern Iowa",1,0,0,1
"14577","Coker","Col Charleston",1,0,0,1
"14578","Coker","South Carolina",1,0,0,1
"14579","Colorado Chr","Air Force",2,0,0,2
"14580","Colorado Chr","N Colorado",2,0,0,2
"14581","Colorado Col","N Colorado",1,0,0,1
"14582","Col Springs","Colorado St",1,0,0,1
"14583","Columbia Intl","Charleston So",2,0,0,2
"14584","Columbia Intl","Coastal Car",1,0,0,1
"14585","Columbia Intl","S Carolina St",1,0,0,1
"14586","Columbus St","UAB",1,0,0,1
"14587","Concordia MI","C Michigan",1,0,0,1
"14588","Concordia MI","E Michigan",2,0,0,2
"14589","Covenant","Chattanooga",1,0,0,1
"14590","Crowley's Ridge","Edwardsville",1,0,0,1
"14591","Crowley's Ridge","Houston Bap",1,0,0,1
"14592","Crowley's Ridge","New Orleans",1,0,0,1
"14593","Crowley's Ridge","TN Martin",1,0,0,1
"14594","CS Dom. Hills","Cal Poly SLO",1,0,0,1
"14595","CS Dom. Hills","CS Fullerton",1,0,0,1
"14596","Dakota St","S Dakota St",1,0,0,1
"14597","Dallas Bap","Oral Roberts",1,0,0,1
"14598","Dallas Bap","UT Arlington",1,0,0,1
"14599","Dallas Chr","Houston Bap",1,0,0,1
"14600","Dallas Chr","Abilene Chr",1,0,0,1
"14601","Dalton St","Austin Peay",1,0,0,1
"14602","Dalton St","Jacksonville St",1,0,0,1
"14603","Daniel Webster","Brown",1,0,0,1
"14604","Daniel Webster","Yale",1,0,0,1
"14605","Defiance","Oakland",1,0,0,1
"14606","Dillard","Alcorn St",2,0,0,2
"14607","Dillard","SE Louisiana",1,0,0,1
"14608","Dillard","South Alabama",1,0,0,1
"14609","Dillard","Southern Univ",2,0,0,2
"14610","Earlham","Bowling Green",1,0,0,1
"14611","Earlham","Evansville",1,0,0,1
"14612","Eastern Univ","UMBC",1,0,0,1
"14613","Ecclesia","Cent Arkansas",1,0,0,1
"14614","Ecclesia","Houston Bap",1,0,0,1
"14615","Eckerd","FL Gulf Coast",1,0,0,1
"14616","Eckerd","UCF",1,0,0,1
"14617","Edward Waters","Florida A&M",1,0,0,1
"14618","Edward Waters","North Florida",2,0,0,2
"14619","Edward Waters","Stetson",1,0,0,1
"14620","Elmhurst","SF Austin",1,0,0,1
"14621","Emory & Henry","Wofford",1,0,0,1
"14622","Emporia St","Missouri KC",0,1,1,1
"14623","Emporia St","Wichita St",1,0,0,1
"14624","Eureka","Bradley",1,0,0,1
"14625","Eureka","E Illinois",1,0,0,1
"14626","Eureka","W Illinois",1,0,0,1
"14627","Evergreen St","Idaho St",1,0,0,1
"14628","Evergreen St","Portland St",1,0,0,1
"14629","Evergreen St","Seattle",1,0,0,1
"14630","Evergreen St","Utah",1,0,0,1
"14631","Fayetteville St","East Carolina",1,0,0,1
"14632","Ferrum","High Point",2,0,0,2
"14633","Fisher","Maine",1,0,0,1
"14634","Fisher","NJIT",2,0,0,2
"14635","Fisk","Middle Tenn St",1,0,0,1
"14636","Fisk","Tennessee St",2,0,0,2
"14637","FL Memorial","Florida A&M",1,0,0,1
"14638","FL Memorial","Florida Intl",1,0,0,1
"14639","Florida Col","Florida Intl",2,0,0,2
"14640","Florida Col","Jacksonville",1,0,0,1
"14641","Florida National","Jacksonville",1,0,0,1
"14642","Florida National","Savannah St",1,0,0,1
"14643","Florida National","Wofford",1,0,0,1
"14644","Fort Valley St","Alabama St",1,0,0,1
"14645","Fort Valley St","Jacksonville St",2,0,0,2
"14646","Fort Valley St","Troy",1,0,0,1
"14647","Goucher","Howard",1,0,0,1
"14648","Goucher","Navy",1,0,0,1
"14649","Goucher","Towson",1,0,0,1
"14650","Goucher","William & Mary",1,0,0,1
"14651","Grace Bib","W Illinois",1,0,0,1
"14652","Graceland","South Dakota",1,0,0,1
"14653","Grand Canyon","Bethune-Cookman",0,1,1,1
"14654","Grand Canyon","Buffalo",1,0,0,1
"14655","Grand Canyon","Chattanooga",1,0,0,1
"14656","Grand Canyon","Chicago St",2,2,0.5,4
"14657","Grand Canyon","C Michigan",1,0,0,1
"14658","Grand Canyon","CS Bakersfield",0,4,1,4
"14659","Grand Canyon","Florida A&M",0,1,1,1
"14660","Grand Canyon","Harvard",1,0,0,1
"14661","Grand Canyon","Idaho",1,1,0.5,2
"14662","Grand Canyon","Idaho St",1,0,0,1
"14663","Grand Canyon","IL Chicago",0,1,1,1
"14664","Grand Canyon","Indiana",1,0,0,1
"14665","Grand Canyon","Kentucky",1,0,0,1
"14666","Grand Canyon","Lamar",0,1,1,1
"14667","Grand Canyon","Loy Marymount",1,0,0,1
"14668","Grand Canyon","Middle Tenn St",1,0,0,1
"14669","Grand Canyon","Missouri KC",2,2,0.5,4
"14670","Grand Canyon","Montana St",0,1,1,1
"14671","Grand Canyon","New Mexico",1,1,0.5,2
"14672","Grand Canyon","New Mexico St",4,0,0,4
"14673","Grand Canyon","Northern Arizona",1,0,0,1
"14674","Grand Canyon","San Diego",1,0,0,1
"14675","Grand Canyon","Savannah St",0,1,1,1
"14676","Grand Canyon","Seattle",0,4,1,4
"14677","Grand Canyon","Tulsa",1,0,0,1
"14678","Grand Canyon","TX Pan American",1,3,0.75,4
"14679","Grand Canyon","UC Riverside",0,1,1,1
"14680","Grand Canyon","Utah",1,0,0,1
"14681","Grand Canyon","Utah Valley",2,2,0.5,4
"14682","Grand Canyon","UT Arlington",1,0,0,1
"14683","Grand Canyon","Abilene Chr",0,1,1,1
"14684","Grand Canyon","Incarnate Word",1,0,0,1
"14685","Grand Canyon","San Diego Chr",0,1,1,1
"14686","Grand Canyon","St Edward's",0,1,1,1
"14687","Grand Canyon","Vanguard",0,1,1,1
"14688","Grand Canyon","W New Mexico",0,1,1,1
"14689","Grand Canyon","MT-Great Falls",0,1,1,1
"14690","Greensboro","Liberty",1,0,0,1
"14691","Greensboro","NC A&T",2,0,0,2
"14692","Greensboro","UNC Greensboro",2,0,0,2
"14693","Greenville","W Illinois",2,0,0,2
"14694","Guilford","Coastal Car",1,0,0,1
"14695","Gwynedd-Mercy","Howard",2,0,0,2
"14696","Hardin-Simmons","Baylor",1,0,0,1
"14697","Haskell","Oral Roberts",1,0,0,1
"14698","Haskell","Utah Valley",1,0,0,1
"14699","Haverford","Stony Brook",1,0,0,1
"14700","Hawaii Hilo","Hawaii",2,0,0,2
"14701","Hawaii Pacific","Long Beach St",1,0,0,1
"14702","Hawaii Pacific","Santa Barbara",1,0,0,1
"14703","Heidelberg","Ohio",1,0,0,1
"14704","Hendrix","Cent Arkansas",1,0,0,1
"14705","Hillsdale","Michigan",1,0,0,1
"14706","Hillsdale","Tennessee Tech",1,0,0,1
"14707","Hillsdale Bap","Houston Bap",1,0,0,1
"14708","Hillsdale Bap","Sam Houston St",1,0,0,1
"14709","Hillsdale Bap","Tennessee Tech",1,0,0,1
"14710","Hillsdale Bap","Abilene Chr",2,0,0,2
"14711","Hiwassee","Chattanooga",2,0,0,2
"14712","Hiwassee","Gardner Webb",2,0,0,2
"14713","Hiwassee","Tennessee Tech",1,0,0,1
"14714","Hiwassee","W Carolina",1,0,0,1
"14715","Hiwassee","Wofford",1,0,0,1
"14716","Holy Names","UC Davis",2,0,0,2
"14717","Hope Intl","CS Northridge",1,0,0,1
"14718","Houghton","Radford",1,0,0,1
"14719","Howard Payne","Sam Houston St",1,0,0,1
"14720","Howard Payne","Texas St",1,0,0,1
"14721","Howard Payne","UT Arlington",2,0,0,2
"14722","Huston-Tillot","Baylor",1,0,0,1
"14723","Huston-Tillot","Lamar",1,0,0,1
"14724","Huston-Tillot","TAM C. Christi",1,0,0,1
"14725","Huston-Tillot","Texas St",1,0,0,1
"14726","Huston-Tillot","TX Pan American",1,0,0,1
"14727","Huston-Tillot","UT San Antonio",2,0,0,2
"14728","Huston-Tillot","Incarnate Word",3,0,0,3
"14729","Immaculata","Lafayette",1,0,0,1
"14730","Incarnate Word","Cent Arkansas",0,2,1,2
"14731","Incarnate Word","Houston Bap",1,2,0.666666666666667,3
"14732","Incarnate Word","Lamar",1,2,0.666666666666667,3
"14733","Incarnate Word","McNeese St",1,1,0.5,2
"14734","Incarnate Word","Missouri KC",0,1,1,1
"14735","Incarnate Word","Nebraska",0,1,1,1
"14736","Incarnate Word","New Orleans",0,2,1,2
"14737","Incarnate Word","Nicholls St",0,3,1,3
"14738","Incarnate Word","North Texas",1,0,0,1
"14739","Incarnate Word","Northwestern LA",2,0,0,2
"14740","Incarnate Word","Oral Roberts",1,0,0,1
"14741","Incarnate Word","Princeton",0,1,1,1
"14742","Incarnate Word","Sam Houston St",1,1,0.5,2
"14743","Incarnate Word","SE Louisiana",2,0,0,2
"14744","Incarnate Word","SF Austin",3,0,0,3
"14745","Incarnate Word","TAM C. Christi",1,2,0.666666666666667,3
"14746","Incarnate Word","Tulsa",1,0,0,1
"14747","Incarnate Word","UTEP",1,0,0,1
"14748","Incarnate Word","Abilene Chr",0,4,1,4
"14749","Incarnate Word","Grand Canyon",0,1,1,1
"14750","Incarnate Word","Huston-Tillot",0,3,1,3
"14751","Incarnate Word","McMurry",0,1,1,1
"14752","Incarnate Word","Northwood TX",0,2,1,2
"14753","Incarnate Word","Open Bible",0,2,1,2
"14754","Incarnate Word","Our Lady Lake",0,1,1,1
"14755","Incarnate Word","St Edward's",0,2,1,2
"14756","Incarnate Word","SW Univ TX",0,1,1,1
"14757","Incarnate Word","Texas A&M Intl",0,2,1,2
"14758","Incarnate Word","Trinity TX",0,1,1,1
"14759","Incarnate Word","UT Tyler",0,1,1,1
"14760","Indiana NW","Chicago St",1,0,0,1
"14761","Indiana NW","IUPUI",1,0,0,1
"14762","Indiana Tech","Detroit",1,0,0,1
"14763","Iowa Wesleyan","Drake",1,0,0,1
"14764","Iowa Wesleyan","NE Omaha",2,0,0,2
"14765","Iowa Wesleyan","South Dakota",1,0,0,1
"14766","IU Kokomo","Ball St",1,0,0,1
"14767","IU Kokomo","IPFW",1,0,0,1
"14768","IU Kokomo","Tennessee Tech",1,0,0,1
"14769","Jarvis Chr","McNeese St",1,0,0,1
"14770","Jarvis Chr","Sam Houston St",1,0,0,1
"14771","Jarvis Chr","TAM C. Christi",1,0,0,1
"14772","Jarvis Chr","Abilene Chr",1,0,0,1
"14773","Johnson Bib","Charleston So",1,0,0,1
"14774","Judson IL","IL Chicago",1,0,0,1
"14775","Judson IL","IPFW",1,0,0,1
"14776","Judson IL","IUPUI",1,0,0,1
"14777","Judson IL","WI Milwaukee",1,0,0,1
"14778","J&W NC","Campbell",2,0,0,2
"14779","J&W NC","Davidson",1,0,0,1
"14780","J&W NC","Mercer",1,0,0,1
"14781","J&W NC","NC Central",2,0,0,2
"14782","J&W NC","Radford",1,0,0,1
"14783","J&W NC","UNC Asheville",1,0,0,1
"14784","J&W NC","Wofford",1,0,0,1
"14785","Kalamazoo","IPFW",1,0,0,1
"14786","Kean","Princeton",1,0,0,1
"14787","Kentucky St","Samford",1,0,0,1
"14788","LaGrange","Troy",1,0,0,1
"14789","La Roche","Cleveland St",1,0,0,1
"14790","La Sierra","CS Northridge",1,0,0,1
"14791","La Sierra","Loy Marymount",1,0,0,1
"14792","La Sierra","Santa Clara",1,0,0,1
"14793","La Verne","CS Bakersfield",1,0,0,1
"14794","La Verne","UC Riverside",1,0,0,1
"14795","Lee-McRae","Appalachian St",1,0,0,1
"14796","Lee-McRae","High Point",1,0,0,1
"14797","LeMoyne-Owen","Memphis",1,0,0,1
"14798","Lesley","Dartmouth",1,0,0,1
"14799","Le Tourneau","Northwestern LA",1,0,0,1
"14800","Limestone","UNC Asheville",1,0,0,1
"14801","Limestone","W Carolina",1,0,0,1
"14802","Louisiana Col","McNeese St",2,0,0,2
"14803","Louisiana Col","Northwestern LA",2,0,0,2
"14804","Louisiana Col","ULL",2,0,0,2
"14805","Louisiana Col","ULM",1,0,0,1
"14806","Loyola NO","Nicholls St",2,0,0,2
"14807","Loyola NO","UTEP",1,0,0,1
"14808","Lyndon St","Brown",1,0,0,1
"14809","Lyndon St","Dartmouth",1,0,0,1
"14810","Lyndon St","Vermont",1,0,0,1
"14811","Lyon","Arkansas St",1,0,0,1
"14812","Lyon","Grambling",1,1,0.5,2
"14813","Lyon","Northwestern LA",1,0,0,1
"14814","MA Lowell","Albany NY",3,1,0.25,4
"14815","MA Lowell","Binghamton",1,3,0.75,4
"14816","MA Lowell","Boston College",1,0,0,1
"14817","MA Lowell","Boston Univ",1,1,0.5,2
"14818","MA Lowell","Brown",2,0,0,2
"14819","MA Lowell","Cincinnati",1,0,0,1
"14820","MA Lowell","Columbia",1,0,0,1
"14821","MA Lowell","Cornell",1,0,0,1
"14822","MA Lowell","Dartmouth",2,0,0,2
"14823","MA Lowell","Duquesne",2,0,0,2
"14824","MA Lowell","Fordham",0,1,1,1
"14825","MA Lowell","Hartford",3,1,0.25,4
"14826","MA Lowell","Maine",0,4,1,4
"14827","MA Lowell","Michigan",1,0,0,1
"14828","MA Lowell","New Hampshire",3,1,0.25,4
"14829","MA Lowell","NJIT",1,3,0.75,4
"14830","MA Lowell","Ohio St",1,0,0,1
"14831","MA Lowell","Rhode Island",2,0,0,2
"14832","MA Lowell","Sacred Heart",0,1,1,1
"14833","MA Lowell","St Bonaventure",1,0,0,1
"14834","MA Lowell","Stony Brook",4,0,0,4
"14835","MA Lowell","Vermont",4,0,0,4
"14836","MA Lowell","Mt Ida",0,2,1,2
"14837","MA Lowell","UMBC",0,4,1,4
"14838","Manchester","Butler",1,0,0,1
"14839","Manchester","C Michigan",1,0,0,1
"14840","Manchester","IPFW",1,0,0,1
"14841","Manchester","Wright St",1,0,0,1
"14842","Mars Hill","Furman",0,1,1,1
"14843","Mars Hill","Longwood",1,0,0,1
"14844","Mars Hill","UNC Greensboro",1,0,0,1
"14845","Mars Hill","Winthrop",1,0,0,1
"14846","Martin Meth","Evansville",1,0,0,1
"14847","Martin Meth","Samford",1,0,0,1
"14848","Marygrove","C Michigan",1,0,0,1
"14849","Marygrove","E Michigan",1,0,0,1
"14850","Mayville St","N Dakota St",1,0,0,1
"14851","Mayville St","North Dakota",1,0,0,1
"14852","McMurry","UT San Antonio",0,1,1,1
"14853","McMurry","Incarnate Word",1,0,0,1
"14854","ME Ft Kent","NJIT",2,0,0,2
"14855","Menlo","Cal Poly SLO",1,0,0,1
"14856","Menlo","Pacific",1,0,0,1
"14857","Mesa St","BYU",1,0,0,1
"14858","Metro St","Canisius",0,1,1,1
"14859","Metro St","Elon",0,1,1,1
"14860","Metro St","F Dickinson",0,1,1,1
"14861","Metro St","Rhode Island",1,0,0,1
"14862","Mid-Continent","Morehead St",1,0,0,1
"14863","Mid-Continent","SE Missouri St",1,0,0,1
"14864","MI Dearborn","Detroit",1,0,0,1
"14865","MI Dearborn","IPFW",1,0,0,1
"14866","Milligan","Appalachian St",1,0,0,1
"14867","Milligan","Lamar",1,0,0,1
"14868","Milligan","ULL",1,0,0,1
"14869","Milligan","W Carolina",1,0,0,1
"14870","Millsaps","New Orleans",1,0,0,1
"14871","Mississippi Col","Alcorn St",1,0,0,1
"14872","Mississippi Col","SF Austin",1,0,0,1
"14873","Missouri S&T","Missouri KC",1,0,0,1
"14874","Missouri S&T","S Illinois",1,0,0,1
"14875","MIT","Harvard",2,0,0,2
"14876","MN Duluth","WI Green Bay",2,0,0,2
"14877","MN Morris","North Dakota",1,0,0,1
"14878","Mobile","Alabama St",1,0,0,1
"14879","Montreat And","Campbell",1,0,0,1
"14880","Montreat And","Chattanooga",2,0,0,2
"14881","Montreat And","Citadel",1,0,0,1
"14882","Montreat And","Presbyterian",2,0,0,2
"14883","Montreat And","SC Upstate",1,0,0,1
"14884","Montreat And","UNC Asheville",1,0,0,1
"14885","Morehouse","Ark Pine Bluff",1,0,0,1
"14886","Mt Ida","MA Lowell",2,0,0,2
"14887","Mt Olive","East Carolina",1,0,0,1
"14888","MT St-Billings","Long Beach St",1,0,0,1
"14889","Mt St Joseph","Wright St",1,0,0,1
"14890","Mt St Vincent","St Francis NY",2,0,0,2
"14891","MT Western","Idaho St",1,0,0,1
"14892","MT Western","Montana",1,0,0,1
"14893","NC Wesleyan","Coastal Car",1,0,0,1
"14894","NC Wesleyan","East Carolina",2,0,0,2
"14895","NC Wesleyan","NC A&T",1,0,0,1
"14896","Newberry","Norfolk St",1,0,0,1
"14897","Newberry","UAB",1,0,0,1
"14898","N Michigan","WI Green Bay",1,0,0,1
"14899","N New Mexico","New Mexico St",2,0,0,2
"14900","N New Mexico","Weber St",1,0,0,1
"14901","N New Mexico","Abilene Chr",2,0,0,2
"14902","North Greenville","Appalachian St",1,0,0,1
"14903","North Greenville","Citadel",1,0,0,1
"14904","North Greenville","SC Upstate",1,0,0,1
"14905","North Park","Valparaiso",1,0,0,1
"14906","Northwestern OH","Toledo",1,0,0,1
"14907","Northwood TX","North Texas",1,0,0,1
"14908","Northwood TX","Rice",1,0,0,1
"14909","Northwood TX","Incarnate Word",2,0,0,2
"14910","Notre Dame CA","San Francisco",2,0,0,2
"14911","Notre Dame OH","Cleveland St",1,0,0,1
"14912","Nova SE","FL Gulf Coast",1,0,0,1
"14913","Nova SE","Florida Intl",0,1,1,1
"14914","NW Nazarene","Boise St",1,0,0,1
"14915","NW Nazarene","Idaho",1,0,0,1
"14916","NW Nazarene","Idaho St",1,0,0,1
"14917","Oakland City","Austin Peay",2,0,0,2
"14918","Oakland City","Ball St",1,0,0,1
"14919","Oakland City","Lipscomb",1,0,0,1
"14920","Oakwood","Alabama A&M",2,0,0,2
"14921","Oberlin","Cornell",1,0,0,1
"14922","Oberlin","Youngstown St",1,0,0,1
"14923","Ohio Northern","Kent",1,0,0,1
"14924","Ohio Valley","Coppin St",1,0,0,1
"14925","Ohio Valley","Wofford",1,0,0,1
"14926","Ohio Valley","MTSU",1,0,0,1
"14927","Olivet Naz","E Illinois",1,0,0,1
"14928","Olivet Naz","S Illinois",1,0,0,1
"14929","Open Bible","Abilene Chr",2,0,0,2
"14930","Open Bible","Incarnate Word",2,0,0,2
"14931","Our Lady Lake","TAM C. Christi",1,0,0,1
"14932","Our Lady Lake","TX Pan American",1,0,0,1
"14933","Our Lady Lake","Incarnate Word",1,0,0,1
"14934","Pacifica","San Diego",1,0,0,1
"14935","Pacifica","San Jose St",1,0,0,1
"14936","Pacifica","UC Irvine",1,0,0,1
"14937","Pacific OR","E Washington",1,0,0,1
"14938","Pac Lutheran","Portland St",1,0,0,1
"14939","Pac Lutheran","Seattle",2,0,0,2
"14940","Permian Basin","TAM C. Christi",0,1,1,1
"14941","Peru St","NE Omaha",1,0,0,1
"14942","Peru St","South Dakota",1,0,0,1
"14943","Philadelphia","Boston College",1,0,0,1
"14944","Presentation","North Dakota",1,0,0,1
"14945","Presentation","Weber St",1,0,0,1
"14946","Purdue Calumet","IL Chicago",1,0,0,1
"14947","Purdue Calumet","IPFW",1,0,0,1
"14948","Randolph Col","Liberty",2,0,0,2
"14949","Reinhardt","Coastal Car",1,0,0,1
"14950","Reinhardt","Mercer",1,0,0,1
"14951","Reinhardt","Tennessee St",1,0,0,1
"14952","Reinhardt","Winthrop",1,0,0,1
"14953","Rio Grande","Marshall",1,0,0,1
"14954","Rio Grande","UCF",1,0,0,1
"14955","R Morris Spfd","Edwardsville",2,0,0,2
"14956","Roanoke","Winthrop",1,0,0,1
"14957","Rochester MI","Detroit",1,0,0,1
"14958","Rochester MI","E Michigan",2,0,0,2
"14959","Rochester MI","Oakland",2,0,0,2
"14960","Rochester MI","TN Martin",1,0,0,1
"14961","Rochester MI","W Michigan",1,0,0,1
"14962","Rockhurst","Loyola-Chicago",2,0,0,2
"14963","Rockhurst","St Louis",2,0,0,2
"14964","Roosevelt","E Illinois",1,0,0,1
"14965","Roosevelt","IL Chicago",1,0,0,1
"14966","Salisbury St","MD E Shore",1,0,0,1
"14967","Salve Regina","Bryant",1,0,0,1
"14968","San Diego Chr","CS Bakersfield",1,0,0,1
"14969","San Diego Chr","Fresno St",1,0,0,1
"14970","San Diego Chr","Loy Marymount",1,0,0,1
"14971","San Diego Chr","Northern Arizona",2,0,0,2
"14972","San Diego Chr","Pepperdine",1,0,0,1
"14973","San Diego Chr","San Diego",2,0,0,2
"14974","San Diego Chr","San Diego St",2,0,0,2
"14975","San Diego Chr","Santa Barbara",1,0,0,1
"14976","San Diego Chr","Santa Clara",1,0,0,1
"14977","San Diego Chr","UC Irvine",1,0,0,1
"14978","San Diego Chr","Utah St",1,0,0,1
"14979","San Diego Chr","Grand Canyon",1,0,0,1
"14980","S Arkansas","Arkansas St",1,0,0,1
"14981","S Arkansas","Ark Little Rock",1,0,0,1
"14982","S Arkansas","Louisiana Tech",1,0,0,1
"14983","Schreiner","Prairie View",2,0,0,2
"14984","Selma AL","Grambling",1,0,0,1
"14985","Selma AL","MS Valley St",1,0,0,1
"14986","Sewanee","Furman",1,0,0,1
"14987","S Francisco St","Cal Poly SLO",1,0,0,1
"14988","S Francisco St","Long Beach St",1,0,0,1
"14989","S Francisco St","Washington St",1,0,0,1
"14990","Shenandoah","Campbell",1,0,0,1
"14991","Siena Hts","W Michigan",1,0,0,1
"14992","Simpson CA","Boise St",1,0,0,1
"14993","Simpson CA","CS Sacramento",1,0,0,1
"14994","Simpson CA","UC Davis",1,0,0,1
"14995","Sonoma St","Illinois St",1,0,0,1
"14996","Sonoma St","San Francisco",1,0,0,1
"14997","Sonoma St","Vermont",1,0,0,1
"14998","Southeastern FL","Liberty",1,0,0,1
"14999","Southeastern FL","Valparaiso",1,0,0,1
"15000","Southern Poly","Georgia St",1,0,0,1
"15001","Spring Hill","Nicholls St",1,0,0,1
"15002","Spring Hill","SE Louisiana",1,0,0,1
"15003","Spring Hill","South Alabama",2,0,0,2
"15004","Spring Hill","Southern Miss",1,0,0,1
"15005","St Andrew's","Campbell",1,0,0,1
"15006","St Andrew's","Charleston So",1,0,0,1
"15007","St Andrew's","Furman",1,0,0,1
"15008","St Andrew's","Mercer",2,0,0,2
"15009","St Andrew's","S Carolina St",2,0,0,2
"15010","St Andrew's","SC Upstate",1,0,0,1
"15011","St Andrew's","UNC Wilmington",1,0,0,1
"15012","St Catharine","Southern Miss",1,0,0,1
"15013","St Catharine","W Carolina",1,0,0,1
"15014","St Edward's","Rice",1,0,0,1
"15015","St Edward's","Grand Canyon",1,0,0,1
"15016","St Edward's","Incarnate Word",2,0,0,2
"15017","St Francis IL","E Michigan",1,0,0,1
"15018","St Francis IL","WI Green Bay",1,0,0,1
"15019","Stillman","Alabama",2,0,0,2
"15020","Stillman","McNeese St",1,0,0,1
"15021","Stillman","Norfolk St",1,0,0,1
"15022","Stillman","Rutgers",1,0,0,1
"15023","St Joseph's IN","Chicago St",1,0,0,1
"15024","St Joseph's IN","N Illinois",1,0,0,1
"15025","St Katherine","Fresno St",1,0,0,1
"15026","St Katherine","San Diego St",1,0,0,1
"15027","St Katherine","San Jose St",1,0,0,1
"15028","St Katherine","Santa Clara",1,0,0,1
"15029","St Katherine","Southern Utah",1,0,0,1
"15030","St Katherine","UC Riverside",1,0,0,1
"15031","St Katherine","UNLV",1,0,0,1
"15032","St Katherine","Utah",1,0,0,1
"15033","St Katherine","Utah Valley",2,0,0,2
"15034","St Katherine","Weber St",1,0,0,1
"15035","St Martin's","Montana",1,0,0,1
"15036","St Thomas TX","Rice",2,0,0,2
"15037","Suffolk","New Hampshire",1,0,0,1
"15038","SW Adventist","Abilene Chr",1,0,0,1
"15039","SW Christian","Montana St",1,0,0,1
"15040","SW Minnesota","S Dakota St",1,0,0,1
"15041","SW Oklahoma","Colorado St",1,0,0,1
"15042","SW Univ TX","Incarnate Word",1,0,0,1
"15043","Tampa","UCF",1,0,0,1
"15044","Taylor IN","Ball St",1,0,0,1
"15045","Texas A&M Intl","Incarnate Word",2,0,0,2
"15046","The Master's","Santa Barbara",2,0,0,2
"15047","Thiel","Youngstown St",2,0,0,2
"15048","Thomas GA","Alabama St",1,0,0,1
"15049","Thomas GA","Gardner Webb",1,0,0,1
"15050","Thomas GA","High Point",1,0,0,1
"15051","Thomas GA","Kennesaw",1,0,0,1
"15052","Thomas GA","ULM",1,0,0,1
"15053","TN Temple","Georgia St",1,0,0,1
"15054","TN Temple","Middle Tenn St",1,0,0,1
"15055","TN Temple","Savannah St",1,0,0,1
"15056","Toccoa Falls","Citadel",1,0,0,1
"15057","Toccoa Falls","Gardner Webb",1,0,0,1
"15058","Toccoa Falls","Ga Southern",1,0,0,1
"15059","Toccoa Falls","Presbyterian",2,0,0,2
"15060","Tougaloo","Alcorn St",1,0,0,1
"15061","Tougaloo","MS Valley St",1,0,0,1
"15062","Trinity Bap","Bethune-Cookman",2,0,0,2
"15063","Trinity Bap","Charleston So",1,0,0,1
"15064","Trinity Bap","Coastal Car",1,0,0,1
"15065","Trinity Bap","Jacksonville",2,0,0,2
"15066","Trinity Bap","North Florida",1,0,0,1
"15067","Trinity FL","Bethune-Cookman",2,0,0,2
"15068","Trinity FL","Ga Southern",1,0,0,1
"15069","Trinity TX","Incarnate Word",1,0,0,1
"15070","Truett-McConnell","Ga Southern",1,0,0,1
"15071","Truett-McConnell","Jacksonville",1,0,0,1
"15072","Truett-McConnell","Kennesaw",1,0,0,1
"15073","Truman St","Indiana St",2,0,0,2
"15074","Tusculum","ETSU",2,0,0,2
"15075","Tusculum","Tennessee",1,0,0,1
"15076","Tusculum","UNC Asheville",1,0,0,1
"15077","Tuskegee","Ark Pine Bluff",1,0,0,1
"15078","UC Merced","CS Bakersfield",1,0,0,1
"15079","UC Merced","Fresno St",1,0,0,1
"15080","UC Santa Cruz","CS Sacramento",1,0,0,1
"15081","UMBC","Akron",1,0,0,1
"15082","UMBC","Albany NY",4,1,0.2,5
"15083","UMBC","American Univ",1,0,0,1
"15084","UMBC","Arizona St",1,0,0,1
"15085","UMBC","Binghamton",3,1,0.25,4
"15086","UMBC","Central Conn",1,0,0,1
"15087","UMBC","Coppin St",1,0,0,1
"15088","UMBC","Duquesne",1,0,0,1
"15089","UMBC","G Washington",2,0,0,2
"15090","UMBC","Hartford",3,1,0.25,4
"15091","UMBC","Howard",1,0,0,1
"15092","UMBC","Iowa",1,0,0,1
"15093","UMBC","Kennesaw",0,1,1,1
"15094","UMBC","Lehigh",2,0,0,2
"15095","UMBC","Longwood",0,1,1,1
"15096","UMBC","Loyola MD",2,0,0,2
"15097","UMBC","Maine",1,3,0.75,4
"15098","UMBC","MD E Shore",1,1,0.5,2
"15099","UMBC","Minnesota",1,0,0,1
"15100","UMBC","Mt St Mary's",0,1,1,1
"15101","UMBC","Navy",1,1,0.5,2
"15102","UMBC","New Hampshire",3,1,0.25,4
"15103","UMBC","NJIT",1,0,0,1
"15104","UMBC","Stony Brook",4,0,0,4
"15105","UMBC","Towson",2,0,0,2
"15106","UMBC","Vermont",5,0,0,5
"15107","UMBC","Eastern Univ",0,1,1,1
"15108","UMBC","MA Lowell",4,0,0,4
"15109","Urbana","Chicago St",1,0,0,1
"15110","Urbana","Wright St",1,0,0,1
"15111","Ursinus","Colgate",1,0,0,1
"15112","UT Tyler","SF Austin",1,0,0,1
"15113","UT Tyler","Texas St",1,0,0,1
"15114","UT Tyler","Incarnate Word",1,0,0,1
"15115","VA Intermont","Longwood",1,0,0,1
"15116","VA Intermont","UNC Asheville",1,0,0,1
"15117","VA Intermont","Winthrop",1,0,0,1
"15118","Valley City St","N Dakota St",1,0,0,1
"15119","VA-Lynchburg","East Carolina",1,0,0,1
"15120","VA-Lynchburg","Elon",1,0,0,1
"15121","VA-Lynchburg","VMI",1,0,0,1
"15122","Vanguard","CS Northridge",1,0,0,1
"15123","Vanguard","Grand Canyon",1,0,0,1
"15124","Virginia Union","Norfolk St",1,0,0,1
"15125","Viterbo","N Dakota St",1,0,0,1
"15126","Voorhees","S Carolina St",1,0,0,1
"15127","Waldorf","NE Omaha",1,0,0,1
"15128","Waldorf","UC Riverside",1,0,0,1
"15129","Walla Walla","E Washington",2,0,0,2
"15130","Walla Walla","Idaho",1,0,0,1
"15131","Walla Walla","Montana St",1,0,0,1
"15132","Walla Walla","Portland St",1,0,0,1
"15133","Warner","FL Atlantic",2,0,0,2
"15134","Warren Wilson","Citadel",1,0,0,1
"15135","Warren Wilson","Coastal Car",1,0,0,1
"15136","Warren Wilson","E Kentucky",1,0,0,1
"15137","Warren Wilson","Florida Intl",1,0,0,1
"15138","Warren Wilson","Kennesaw",1,0,0,1
"15139","Warren Wilson","Youngstown St",1,0,0,1
"15140","Washington MD","Howard",1,0,0,1
"15141","Washington MD","VMI",1,0,0,1
"15142","Washington MD","William & Mary",1,0,0,1
"15143","Wash & Lee","Elon",1,0,0,1
"15144","Wayland","North Texas",1,0,0,1
"15145","Wayland","TX Pan American",1,0,0,1
"15146","Wayland","Utah St",1,0,0,1
"15147","Wayne St NE","S Dakota St",2,0,0,2
"15148","Wayne St NE","South Dakota",1,0,0,1
"15149","Webber","North Florida",2,0,0,2
"15150","West Alabama","Citadel",0,1,1,1
"15151","West Alabama","USC",1,0,0,1
"15152","West Alabama","UTEP",1,0,0,1
"15153","West Alabama","Abilene Chr",0,1,1,1
"15154","Western St CO","Air Force",2,0,0,2
"15155","Western St CO","Wyoming",2,0,0,2
"15156","Westminster PA","Youngstown St",1,0,0,1
"15157","Westminster UT","San Jose St",1,0,0,1
"15158","Wheelock","New Hampshire",1,0,0,1
"15159","Wheelock","NJIT",1,0,0,1
"15160","Wiley","TX Southern",1,0,0,1
"15161","Wilmington DE","MD E Shore",0,1,1,1
"15162","Wilmington OH","Miami OH",0,1,1,1
"15163","Wingate","UNC Wilmington",1,0,0,1
"15164","WI Parkside","Chicago St",1,0,0,1
"15165","Wittenberg","W Carolina",1,0,0,1
"15166","Wm Carey","South Alabama",1,0,0,1
"15167","Wm Carey","Southern Miss",2,0,0,2
"15168","Wm Jessup","CS Sacramento",1,0,0,1
"15169","Wm Jessup","St Mary's CA",1,0,0,1
"15170","W New Mexico","Abilene Chr",1,0,0,1
"15171","W New Mexico","Grand Canyon",1,0,0,1
"15172","WV Tech","Longwood",1,0,0,1
"15173","WV Tech","Marshall",1,0,0,1
"15174","WV Wesleyan","Buffalo",1,0,0,1
"15175","Young Harris","Georgia St",1,0,0,1
"15176","Young Harris","UAB",1,0,0,1
"15177","Adams St","Boise St",1,0,0,1
"15178","Adams St","Nevada",1,0,0,1
"15179","Alfred St","Cornell",1,0,0,1
"15180","Alma","C Michigan",1,0,0,1
"15181","Aquinas","Detroit",1,0,0,1
"15182","Aquinas","W Michigan",1,0,0,1
"15183","Arkansas Tech","SF Austin",1,0,0,1
"15184","Ark Monticello","Ark Little Rock",1,0,0,1
"15185","Ark Monticello","Nicholls St",1,0,0,1
"15186","Ark Monticello","North Texas",1,0,0,1
"15187","Aurora","N Illinois",1,0,0,1
"15188","Austin Col","Sam Houston St",1,0,0,1
"15189","Averett","Longwood",1,0,0,1
"15190","Avila","Missouri St",1,0,0,1
"15191","Avila","South Dakota",1,0,0,1
"15192","Baker KS","E Illinois",1,0,0,1
"15193","Berea","Austin Peay",1,0,0,1
"15194","Berry","Lipscomb",1,0,0,1
"15195","Bluffton","Akron",1,0,0,1
"15196","Bob Jones","Citadel",1,0,0,1
"15197","Bob Jones","Presbyterian",1,0,0,1
"15198","Bob Jones","SC Upstate",1,0,0,1
"15199","Bristol","CS Bakersfield",1,0,0,1
"15200","Bristol","CS Sacramento",1,0,0,1
"15201","Bristol","Fresno St",1,0,0,1
"15202","Bristol","Utah Valley",1,0,0,1
"15203","Bristol","Weber St",1,0,0,1
"15204","Cal Lutheran","Pepperdine",1,0,0,1
"15205","Cal Maritime","UC Davis",1,0,0,1
"15206","Cal St-LA","St Mary's CA",1,0,0,1
"15207","Capital","Miami OH",1,0,0,1
"15208","Case Western","Bucknell",1,0,0,1
"15209","Catawba","George Mason",1,0,0,1
"15210","Catawba","Radford",1,0,0,1
"15211","Chadron St","S Dakota St",1,0,0,1
"15212","Chapman","UC Irvine",1,0,0,1
"15213","Cheyney St","Delaware St",1,0,0,1
"15214","Cin Clermont","E Kentucky",1,0,0,1
"15215","Cin Clermont","N Kentucky",1,0,0,1
"15216","Clayton St","Mississippi St",1,0,0,1
"15217","College of Faith","NC Central",1,0,0,1
"15218","Concordia AL","Alcorn St",0,1,1,1
"15219","Concordia OR","Oregon",1,0,0,1
"15220","Concordia OR","Portland",1,0,0,1
"15221","Concordia SP","WI Milwaukee",1,0,0,1
"15222","Corban","Oregon St",1,0,0,1
"15223","CSU East Bay","CS Fullerton",1,0,0,1
"15224","CSU East Bay","Pacific",1,0,0,1
"15225","Dickinson St ND","North Dakota",1,0,0,1
"15226","Eastern Oregon","E Washington",1,0,0,1
"15227","Eastern Oregon","Idaho",1,0,0,1
"15228","Emerson","Hartford",1,0,0,1
"15229","Erskine","Charleston So",1,0,0,1
"15230","FDU Madison","F Dickinson",1,0,0,1
"15231","Ferris St","Bowling Green",0,1,1,1
"15232","Flagler","South Florida",1,0,0,1
"15233","Florida Tech","FL Gulf Coast",1,0,0,1
"15234","Florida Tech","Stetson",1,0,0,1
"15235","Franklin Pierce","Minnesota",1,0,0,1
"15236","Franklin Pierce","St John's",1,0,0,1
"15237","Fresno Pacific","Long Beach St",1,0,0,1
"15238","Goldey Beacom","Coppin St",1,0,0,1
"15239","Goshen","Valparaiso",1,0,0,1
"15240","Hampden-Sydney","UC Irvine",1,0,0,1
"15241","Hannibal-Lagr","SE Missouri St",1,0,0,1
"15242","Harris-Stowe","Edwardsville",1,0,0,1
"15243","Harris-Stowe","SE Missouri St",1,0,0,1
"15244","Hartwick","Binghamton",1,0,0,1
"15245","Hood","Howard",1,0,0,1
"15246","IL Springfield","WI Green Bay",1,0,0,1
"15247","IN S Bend","Valparaiso",1,0,0,1
"15248","Johnson FL","Ga Southern",1,0,0,1
"15249","Johnson TN","Charleston So",1,0,0,1
"15250","Johnson TN","VMI",1,0,0,1
"15251","J&W RI","Brown",1,0,0,1
"15252","Kentucky Chr","E Kentucky",1,0,0,1
"15253","Kentucky Chr","Morehead St",1,0,0,1
"15254","Keystone","St Francis PA",1,0,0,1
"15255","King TN","Marshall",1,0,0,1
"15256","Langston","North Texas",1,0,0,1
"15257","Langston","SE Louisiana",1,0,0,1
"15258","Lewis & Clark","Portland",1,0,0,1
"15259","Lewis-Clark ID","E Washington",1,0,0,1
"15260","LSU-Alexandria","Lamar",1,0,0,1
"15261","LSU-Alexandria","McNeese St",1,0,0,1
"15262","LSU-Alexandria","Northwestern LA",1,0,0,1
"15263","LSU-Alexandria","Southern Univ",1,0,0,1
"15264","LSU-Alexandria","ULM",1,0,0,1
"15265","Malone","Kent",1,0,0,1
"15266","McKendree","Loyola-Chicago",1,0,0,1
"15267","Merchant Marine","Stony Brook",1,0,0,1
"15268","Mid-Atlantic Chr","VMI",1,0,0,1
"15269","Mid Georgia","Savannah St",1,0,0,1
"15270","Midwest TX St","SMU",1,0,0,1
"15271","Miles","Jacksonville St",1,0,0,1
"15272","Missouri Val","Northwestern LA",1,0,0,1
"15273","Mitchell","Sacred Heart",1,0,0,1
"15274","MN Crookston","N Dakota St",1,0,0,1
"15275","MN Crookston","WI Milwaukee",1,0,0,1
"15276","Morrisville St","Colgate",1,0,0,1
"15277","MT-Great Falls","Grand Canyon",1,0,0,1
"15278","MTSU","Akron",0,1,1,1
"15279","MTSU","Auburn",1,0,0,1
"15280","MTSU","Belmont",1,0,0,1
"15281","MTSU","Charlotte",0,2,1,2
"15282","MTSU","Chattanooga",0,1,1,1
"15283","MTSU","Cincinnati",1,0,0,1
"15284","MTSU","Creighton",1,0,0,1
"15285","MTSU","FL Atlantic",0,2,1,2
"15286","MTSU","Florida Intl",1,1,0.5,2
"15287","MTSU","Louisiana Tech",2,0,0,2
"15288","MTSU","Marshall",0,1,1,1
"15289","MTSU","Murray St",1,0,0,1
"15290","MTSU","Northern Arizona",0,1,1,1
"15291","MTSU","North Texas",1,0,0,1
"15292","MTSU","Oklahoma St",1,0,0,1
"15293","MTSU","Old Dominion",0,2,1,2
"15294","MTSU","Rice",1,0,0,1
"15295","MTSU","South Alabama",0,1,1,1
"15296","MTSU","Southern Miss",0,2,1,2
"15297","MTSU","Southern Univ",0,1,1,1
"15298","MTSU","Tennessee St",0,1,1,1
"15299","MTSU","UAB",3,0,0,3
"15300","MTSU","UTEP",1,1,0.5,2
"15301","MTSU","UT San Antonio",1,0,0,1
"15302","MTSU","W Kentucky",0,1,1,1
"15303","MTSU","Ohio Valley",0,1,1,1
"15304","MT Tech","Montana",1,0,0,1
"15305","Mt Vernon Naz","Cleveland St",1,0,0,1
"15306","Newbury","Yale",1,0,0,1
"15307","Newman","Wichita St",1,0,0,1
"15308","Nichols","Holy Cross",1,0,0,1
"15309","NM Highlands","New Mexico St",1,0,0,1
"15310","North Alabama","Auburn",1,0,0,1
"15311","Northland","N Dakota St",1,0,0,1
"15312","Northwest Chr","Nevada",1,0,0,1
"15313","Northwest WA","Seattle",1,0,0,1
"15314","NW Oklahoma St","Oklahoma St",1,0,0,1
"15315","NYIT","Fordham",1,0,0,1
"15316","OH Dominican","Wright St",1,0,0,1
"15317","Ohio Mid-Western","N Kentucky",1,0,0,1
"15318","Old Westbury","Wagner",1,0,0,1
"15319","Ouachita","SF Austin",1,0,0,1
"15320","Pace","Rhode Island",1,0,0,1
"15321","Pacific Union","Pacific",1,0,0,1
"15322","Paine","Kennesaw",1,0,0,1
"15323","Palm Beach Atl","Stetson",1,0,0,1
"15324","Peace","High Point",1,0,0,1
"15325","Pensacola Chr","New Orleans",1,0,0,1
"15326","Pfeiffer","Norfolk St",1,0,0,1
"15327","Pfeiffer","Winthrop",1,0,0,1
"15328","Piedmont","Mercer",1,0,0,1
"15329","Piedmont","Presbyterian",1,0,0,1
"15330","Piedmont Bap","Coastal Car",1,0,0,1
"15331","Piedmont Bap","Tennessee Tech",1,0,0,1
"15332","PSU-Beaver","Longwood",1,0,0,1
"15333","PSU-Harrisburg","Navy",1,0,0,1
"15334","PSU Mont Alto","Lehigh",1,0,0,1
"15335","Quincy","Illinois St",1,0,0,1
"15336","Regis CO","Wyoming",1,0,0,1
"15337","Rhodes","Lipscomb",1,0,0,1
"15338","Rowan","Princeton",1,0,0,1
"15339","Sarah Lawrence","NJIT",1,0,0,1
"15340","S Dakota Tech","Montana St",1,0,0,1
"15341","SE Oklahoma","Tulsa",0,1,1,1
"15342","Simpson IA","Drake",1,0,0,1
"15343","Southern N.O.","McNeese St",1,0,0,1
"15344","Southern N.O.","Tulane",1,0,0,1
"15345","St Joseph's NY","NJIT",1,0,0,1
"15346","St Rose","Harvard",1,0,0,1
"15347","St Xavier IL","IL Chicago",1,0,0,1
"15348","Susquehanna","Lafayette",1,0,0,1
"15349","S Vermont","Vermont",1,0,0,1
"15350","S Virginia","BYU",1,0,0,1
"15351","Tabor","Oral Roberts",1,0,0,1
"15352","Texas Col","Sam Houston St",1,0,0,1
"15353","Thomas Aquinas","Gonzaga",1,0,0,1
"15354","Thomas Aquinas","Stony Brook",1,0,0,1
"15355","Thomas ME","New Hampshire",1,0,0,1
"15356","Tiffin","Cleveland St",1,0,0,1
"15357","Transylvania","Lipscomb",1,0,0,1
"15358","Trevecca Naz","Belmont",1,0,0,1
"15359","Trevecca Naz","Vanderbilt",1,0,0,1
"15360","Trinity Chr","Chicago St",1,0,0,1
"15361","Trinity IL","Valparaiso",1,0,0,1
"15362","TX A&M K'ville","TX Pan American",1,0,0,1
"15363","TX Lutheran","Texas St",1,0,0,1
"15364","UC San Diego","UC Riverside",1,0,0,1
"15365","Univ of Southwest","Sam Houston St",1,0,0,1
"15366","Univ Sciences","Drexel",0,1,1,1
"15367","UVA-Wise","ETSU",1,0,0,1
"15368","UVA-Wise","Norfolk St",1,0,0,1
"15369","Wentworth Tech","Boston Univ",1,0,0,1
"15370","Wilberforce","Youngstown St",1,0,0,1
"15371","Willamette","Portland St",1,0,0,1
"15372","Wm Jewell","Missouri KC",1,0,0,1
